,fips_code,state,county_name,exp_deaths_med,all_obs,covid,excess,unexplained_excess,unexplained_excess_ratio,Excess Death Ratio Percentile Groups
0,01001,Alabama,Autauga,941,1187,156,246,90,0.365853658536585,50th-75th percentile
1,01003,Alabama,Baldwin,4095,5002,584,907,323,0.356119073869901,50th-75th percentile
2,01005,Alabama,Barbour,530,647,87,117,30,0.256410256410256,50th-75th percentile
3,01011,Alabama,Bullock,206,239,33,33,0,0.0,25th-50th percentile
4,01067,Alabama,Henry,402,473,61,71,10,0.140845070422535,25th-50th percentile
5,01007,Alabama,Bibb,446,549,85,103,18,0.174757281553398,25th-50th percentile
6,01021,Alabama,Chilton,890,1127,175,237,62,0.261603375527426,50th-75th percentile
7,01037,Alabama,Coosa,278,311,39,33,-6,-0.181818181818182,Bottom 25th percentile
8,01105,Alabama,Perry,208,293,42,85,43,0.505882352941176,Top 25th percentile
9,01009,Alabama,Blount,1189,1459,183,270,87,0.322222222222222,50th-75th percentile
10,01013,Alabama,Butler,450,523,96,73,-23,-0.315068493150685,Bottom 25th percentile
11,01041,Alabama,Crenshaw,345,432,57,87,30,0.344827586206897,50th-75th percentile
12,01109,Alabama,Pike,553,765,115,212,97,0.457547169811321,Top 25th percentile
13,01015,Alabama,Calhoun,2547,3146,457,599,142,0.237061769616027,25th-50th percentile
14,01017,Alabama,Chambers,729,1028,147,299,152,0.508361204013378,Top 25th percentile
15,01029,Alabama,Cleburne,342,433,65,91,26,0.285714285714286,50th-75th percentile
16,01111,Alabama,Randolph,532,640,108,108,0,0.0,25th-50th percentile
17,01019,Alabama,Cherokee,624,811,89,187,98,0.524064171122995,Top 25th percentile
18,01055,Alabama,Etowah,2461,3091,495,630,135,0.214285714285714,25th-50th percentile
19,01023,Alabama,Choctaw,323,344,53,21,-32,-1.52380952380952,Bottom 25th percentile
20,01025,Alabama,Clarke,530,735,94,205,111,0.541463414634146,Top 25th percentile
21,01129,Alabama,Washington,351,396,56,45,-11,-0.244444444444444,Bottom 25th percentile
22,01027,Alabama,Clay,318,406,62,88,26,0.295454545454545,50th-75th percentile
23,01121,Alabama,Talladega,1731,2208,318,477,159,0.333333333333333,50th-75th percentile
24,01031,Alabama,Coffee,987,1241,193,254,61,0.240157480314961,25th-50th percentile
25,01061,Alabama,Geneva,648,889,131,241,110,0.45643153526971,Top 25th percentile
26,01033,Alabama,Colbert,1312,1497,190,185,-5,-0.027027027027027,25th-50th percentile
27,01035,Alabama,Conecuh,326,387,61,61,0,0.0,25th-50th percentile
28,01091,Alabama,Marengo,483,592,94,109,15,0.137614678899083,25th-50th percentile
29,01099,Alabama,Monroe,469,616,81,147,66,0.448979591836735,Top 25th percentile
30,01131,Alabama,Wilcox,249,292,45,43,-2,-0.0465116279069768,Bottom 25th percentile
31,01039,Alabama,Covington,954,1214,208,260,52,0.2,25th-50th percentile
32,01053,Alabama,Escambia,811,1088,163,277,114,0.411552346570397,50th-75th percentile
33,01043,Alabama,Cullman,1863,2205,292,342,50,0.146198830409357,25th-50th percentile
34,01045,Alabama,Dale,929,1177,173,248,75,0.30241935483871,50th-75th percentile
35,01047,Alabama,Dallas,839,1131,191,292,101,0.345890410958904,50th-75th percentile
36,01085,Alabama,Lowndes,269,319,71,50,-21,-0.42,Bottom 25th percentile
37,01049,Alabama,DeKalb,1410,1848,278,438,160,0.365296803652968,50th-75th percentile
38,01051,Alabama,Elmore,1405,1843,245,438,193,0.440639269406393,Top 25th percentile
39,01057,Alabama,Fayette,393,510,91,117,26,0.222222222222222,25th-50th percentile
40,01075,Alabama,Lamar,343,419,72,76,4,0.0526315789473684,25th-50th percentile
41,01093,Alabama,Marion,723,928,129,205,76,0.370731707317073,50th-75th percentile
42,01059,Alabama,Franklin,649,807,101,158,57,0.360759493670886,50th-75th percentile
43,01079,Alabama,Lawrence,702,955,141,253,112,0.442687747035573,Top 25th percentile
44,01063,Alabama,Greene,185,265,42,80,38,0.475,Top 25th percentile
45,01065,Alabama,Hale,357,441,73,84,11,0.130952380952381,25th-50th percentile
46,01107,Alabama,Pickens,447,578,82,131,49,0.374045801526718,50th-75th percentile
47,01119,Alabama,Sumter,295,308,41,13,-28,-2.15384615384615,Bottom 25th percentile
48,01069,Alabama,Houston,2026,2669,406,643,237,0.368584758942457,50th-75th percentile
49,01071,Alabama,Jackson,1249,1641,213,392,179,0.456632653061225,Top 25th percentile
50,01073,Alabama,Jefferson,12275,14730,1738,2455,717,0.292057026476578,50th-75th percentile
51,01077,Alabama,Lauderdale,1988,2321,289,333,44,0.132132132132132,25th-50th percentile
52,01081,Alabama,Lee,1974,2362,312,388,76,0.195876288659794,25th-50th percentile
53,01083,Alabama,Limestone,1554,1931,202,377,175,0.464190981432361,Top 25th percentile
54,01087,Alabama,Macon,420,502,64,82,18,0.219512195121951,25th-50th percentile
55,01123,Alabama,Tallapoosa,974,1179,175,205,30,0.146341463414634,25th-50th percentile
56,01089,Alabama,Madison,5890,6694,637,804,167,0.20771144278607,25th-50th percentile
57,01095,Alabama,Marshall,2018,2455,285,437,152,0.347826086956522,50th-75th percentile
58,01097,Alabama,Mobile,7652,9536,1291,1884,593,0.314755838641189,50th-75th percentile
59,01101,Alabama,Montgomery,3680,4807,701,1127,426,0.377994676131322,50th-75th percentile
60,01103,Alabama,Morgan,2413,2957,353,544,191,0.351102941176471,50th-75th percentile
61,01113,Alabama,Russell,1084,1321,188,237,49,0.206751054852321,25th-50th percentile
62,01115,Alabama,St. Clair,1681,2172,341,491,150,0.305498981670061,50th-75th percentile
63,01117,Alabama,Shelby,2735,3214,352,479,127,0.265135699373695,50th-75th percentile
64,01125,Alabama,Tuscaloosa,3122,3914,594,792,198,0.25,50th-75th percentile
65,01127,Alabama,Walker,1757,2266,353,509,156,0.306483300589391,50th-75th percentile
66,01133,Alabama,Winston,543,702,102,159,57,0.358490566037736,50th-75th percentile
67,02020,Alaska,Anchorage,2796,3555,338,759,421,0.55467720685112,Top 25th percentile
68,02090,Alaska,Fairbanks North Star,737,962,99,225,126,0.56,Top 25th percentile
69,02122,Alaska,Kenai Peninsula,778,842,68,64,-4,-0.0625,Bottom 25th percentile
70,02170,Alaska,Matanuska-Susitna,1033,1381,161,348,187,0.537356321839081,Top 25th percentile
71,02140,Alaska,Northern Alaska,72,89,11,17,6,0.352941176470588,50th-75th percentile
72,02180,Alaska,Nome,107,123,10,16,6,0.375,50th-75th percentile
73,02185,Alaska,North Slope,84,78,14,-6,-20,3.33333333333333,Top 25th percentile
74,02240,Alaska,Southeast Fairbanks,158,200,23,42,19,0.452380952380952,Top 25th percentile
75,02261,Alaska,Valdez-Cordova,93,7,7,-86,-93,1.08139534883721,Top 25th percentile
76,02100,Alaska,Haines,24,39,12,15,3,0.2,25th-50th percentile
77,02110,Alaska,Juneau,321,355,15,34,19,0.558823529411765,Top 25th percentile
78,02195,Alaska,Petersburg,381,493,59,112,53,0.473214285714286,Top 25th percentile
79,02220,Alaska,Sitka,100,112,4,12,8,0.666666666666667,Top 25th percentile
80,02232,Alaska,Southeast Alaska,28,49,12,21,9,0.428571428571429,Top 25th percentile
81,02010,Alaska,Southwest Alaska,37,24,21,-13,-34,2.61538461538462,Top 25th percentile
82,02050,Alaska,Bethel,164,202,31,38,7,0.184210526315789,25th-50th percentile
83,02060,Alaska,Bristol Bay,8,16,9,8,-1,-0.125,Bottom 25th percentile
84,02070,Alaska,Dillingham,67,75,9,8,-1,-0.125,Bottom 25th percentile
85,02150,Alaska,Kodiak Island,99,143,7,44,37,0.840909090909091,Top 25th percentile
86,02158,Alaska,Southwest Alaska,75,94,6,19,13,0.68421052631579,Top 25th percentile
87,04001,Arizona,Apache,1081,1849,511,768,257,0.334635416666667,50th-75th percentile
88,04003,Arizona,Cochise,2378,2870,366,492,126,0.25609756097561,50th-75th percentile
89,04009,Arizona,Graham,525,696,103,171,68,0.39766081871345,50th-75th percentile
90,04011,Arizona,Greenlee,110,122,17,12,-5,-0.416666666666667,Bottom 25th percentile
91,04005,Arizona,Coconino,1353,1837,341,484,143,0.295454545454545,50th-75th percentile
92,04007,Arizona,Gila,1315,1652,220,337,117,0.347181008902077,50th-75th percentile
93,04025,Arizona,Yavapai,5397,6416,603,1019,416,0.408243375858685,50th-75th percentile
94,04013,Arizona,Maricopa,55923,69826,9472,13903,4431,0.318708192476444,50th-75th percentile
95,04015,Arizona,Mohave,5889,7216,878,1327,449,0.33835719668425,50th-75th percentile
96,04017,Arizona,Navajo,1759,2815,605,1056,451,0.427083333333333,Top 25th percentile
97,04019,Arizona,Pima,16849,20604,2468,3755,1287,0.342743009320905,50th-75th percentile
98,04023,Arizona,Santa Cruz,533,755,169,222,53,0.238738738738739,25th-50th percentile
99,04021,Arizona,Pinal,5910,7655,1020,1745,725,0.415472779369628,Top 25th percentile
100,04027,Arizona,Yuma,3329,4559,940,1230,290,0.235772357723577,25th-50th percentile
101,05001,Arkansas,Arkansas (county),426,539,49,113,64,0.566371681415929,Top 25th percentile
102,05095,Arkansas,Monroe,202,231,30,29,-1,-0.0344827586206897,25th-50th percentile
103,05107,Arkansas,Phillips,412,530,88,118,30,0.254237288135593,50th-75th percentile
104,05117,Arkansas,Prairie,195,263,33,68,35,0.514705882352941,Top 25th percentile
105,05005,Arkansas,Baxter,1218,1526,186,308,122,0.396103896103896,50th-75th percentile
106,05089,Arkansas,Marion,459,552,56,93,37,0.397849462365591,50th-75th percentile
107,05007,Arkansas,Benton,3504,4064,602,560,-42,-0.075,Bottom 25th percentile
108,05009,Arkansas,Boone,798,960,123,162,39,0.240740740740741,25th-50th percentile
109,05015,Arkansas,Carroll,564,656,70,92,22,0.239130434782609,25th-50th percentile
110,05087,Arkansas,Madison,348,372,34,24,-10,-0.416666666666667,Bottom 25th percentile
111,05011,Arkansas,Bradley,290,295,43,5,-38,-7.6,Bottom 25th percentile
112,05013,Arkansas,Calhoun,130,144,9,14,5,0.357142857142857,50th-75th percentile
113,05025,Arkansas,Cleveland,186,226,31,40,9,0.225,25th-50th percentile
114,05139,Arkansas,Union,885,1062,130,177,47,0.265536723163842,50th-75th percentile
115,05019,Arkansas,Clark,439,513,50,74,24,0.324324324324324,50th-75th percentile
116,05039,Arkansas,Dallas,184,221,19,37,18,0.486486486486487,Top 25th percentile
117,05103,Arkansas,Ouachita,600,676,78,76,-2,-0.0263157894736842,25th-50th percentile
118,05021,Arkansas,Clay,401,463,64,62,-2,-0.032258064516129,25th-50th percentile
119,05055,Arkansas,Greene,875,1017,119,142,23,0.161971830985916,25th-50th percentile
120,05027,Arkansas,Columbia,499,586,52,87,35,0.402298850574713,50th-75th percentile
121,05073,Arkansas,Lafayette,169,205,18,36,18,0.5,Top 25th percentile
122,05091,Arkansas,Miller,869,1076,153,207,54,0.260869565217391,50th-75th percentile
123,05029,Arkansas,Conway,492,508,35,16,-19,-1.1875,Bottom 25th percentile
124,05115,Arkansas,Pope,1078,1324,138,246,108,0.439024390243902,Top 25th percentile
125,05031,Arkansas,Craighead,1719,2035,193,316,123,0.389240506329114,50th-75th percentile
126,05033,Arkansas,Crawford,1133,1425,159,292,133,0.455479452054795,Top 25th percentile
127,05035,Arkansas,Crittenden,868,1150,146,282,136,0.482269503546099,Top 25th percentile
128,05037,Arkansas,Cross,402,457,52,55,3,0.0545454545454545,25th-50th percentile
129,05077,Arkansas,Lee,193,291,43,98,55,0.561224489795918,Top 25th percentile
130,05123,Arkansas,St. Francis,461,545,77,84,7,0.0833333333333333,25th-50th percentile
131,05045,Arkansas,Faulkner,1784,1971,177,187,10,0.053475935828877,25th-50th percentile
132,05047,Arkansas,Franklin,407,467,49,60,11,0.183333333333333,25th-50th percentile
133,05071,Arkansas,Johnson,483,555,61,72,11,0.152777777777778,25th-50th percentile
134,05083,Arkansas,Logan,503,614,42,111,69,0.621621621621622,Top 25th percentile
135,05051,Arkansas,Garland,2466,2824,353,358,5,0.0139664804469274,25th-50th percentile
136,05053,Arkansas,Grant,371,459,53,88,35,0.397727272727273,50th-75th percentile
137,05059,Arkansas,Hot Spring,745,884,103,139,36,0.258992805755396,50th-75th percentile
138,05057,Arkansas,Hempstead,427,467,42,40,-2,-0.05,Bottom 25th percentile
139,05061,Arkansas,Howard,339,318,32,-21,-53,2.52380952380952,Top 25th percentile
140,05099,Arkansas,Nevada,203,216,39,13,-26,-2.0,Bottom 25th percentile
141,05109,Arkansas,Pike,242,273,44,31,-13,-0.419354838709677,Bottom 25th percentile
142,05063,Arkansas,Independence,717,930,135,213,78,0.366197183098592,50th-75th percentile
143,05067,Arkansas,Jackson,388,473,41,85,44,0.517647058823529,Top 25th percentile
144,05147,Arkansas,Woodruff,174,199,22,25,3,0.12,25th-50th percentile
145,05069,Arkansas,Jefferson,1360,1715,229,355,126,0.354929577464789,50th-75th percentile
146,05081,Arkansas,Little River,313,374,59,61,2,0.0327868852459016,25th-50th percentile
147,05113,Arkansas,Polk,480,583,119,103,-16,-0.155339805825243,Bottom 25th percentile
148,05133,Arkansas,Sevier,301,385,61,84,23,0.273809523809524,50th-75th percentile
149,05085,Arkansas,Lonoke,1209,1418,156,209,53,0.253588516746412,50th-75th percentile
150,05093,Arkansas,Mississippi,855,1070,134,215,81,0.376744186046512,50th-75th percentile
151,05111,Arkansas,Poinsett,588,731,82,143,61,0.426573426573427,Top 25th percentile
152,05097,Arkansas,Montgomery,244,287,52,43,-9,-0.209302325581395,Bottom 25th percentile
153,05105,Arkansas,Perry,221,245,19,24,5,0.208333333333333,25th-50th percentile
154,05127,Arkansas,Scott,228,296,31,68,37,0.544117647058824,Top 25th percentile
155,05149,Arkansas,Yell,459,491,67,32,-35,-1.09375,Bottom 25th percentile
156,05119,Arkansas,Pulaski,6470,7699,788,1229,441,0.358828315703824,50th-75th percentile
157,05125,Arkansas,Saline,2082,2432,247,350,103,0.294285714285714,50th-75th percentile
158,05131,Arkansas,Sebastian,2296,2825,298,529,231,0.436672967863894,Top 25th percentile
159,05049,Arkansas,Fulton,354,400,67,46,-21,-0.456521739130435,Bottom 25th percentile
160,05065,Arkansas,Izard,364,415,42,51,9,0.176470588235294,25th-50th percentile
161,05075,Arkansas,Lawrence,416,445,46,29,-17,-0.586206896551724,Bottom 25th percentile
162,05121,Arkansas,Randolph,450,504,67,54,-13,-0.240740740740741,Bottom 25th percentile
163,05135,Arkansas,Sharp,512,550,57,38,-19,-0.5,Bottom 25th percentile
164,05003,Arkansas,Ashley,446,539,56,93,37,0.397849462365591,50th-75th percentile
165,05017,Arkansas,Chicot,278,297,37,19,-18,-0.947368421052632,Bottom 25th percentile
166,05041,Arkansas,Desha,299,312,36,13,-23,-1.76923076923077,Bottom 25th percentile
167,05043,Arkansas,Drew,367,436,44,69,25,0.36231884057971,50th-75th percentile
168,05079,Arkansas,Lincoln,275,313,54,38,-16,-0.421052631578947,Bottom 25th percentile
169,05023,Arkansas,Cleburne,669,757,91,88,-3,-0.0340909090909091,25th-50th percentile
170,05101,Arkansas,Newton,166,245,27,79,52,0.658227848101266,Top 25th percentile
171,05129,Arkansas,Searcy,202,235,26,33,7,0.212121212121212,25th-50th percentile
172,05137,Arkansas,Stone,326,403,38,77,39,0.506493506493507,Top 25th percentile
173,05141,Arkansas,Van Buren,442,484,47,42,-5,-0.119047619047619,Bottom 25th percentile
174,05143,Arkansas,Washington,3034,3366,433,332,-101,-0.30421686746988,Bottom 25th percentile
175,05145,Arkansas,White,1494,1800,159,306,147,0.480392156862745,Top 25th percentile
176,06001,California,Alameda,17720,19177,1391,1457,66,0.0452985586822237,25th-50th percentile
177,06003,California,Alpine,37,39,8,2,-6,-3.0,Bottom 25th percentile
178,06005,California,Amador,790,895,55,105,50,0.476190476190476,Top 25th percentile
179,06009,California,Calaveras,879,1006,65,127,62,0.488188976377953,Top 25th percentile
180,06027,California,Inyo,381,410,43,29,-14,-0.482758620689655,Bottom 25th percentile
181,06051,California,Mono,107,92,6,-15,-21,1.4,Top 25th percentile
182,06007,California,Butte,3817,4057,371,240,-131,-0.545833333333333,Bottom 25th percentile
183,06011,California,Colusa,303,301,35,-2,-37,18.5,Top 25th percentile
184,06033,California,Lake,1440,1479,125,39,-86,-2.20512820512821,Bottom 25th percentile
185,06013,California,Contra Costa,13963,15305,1028,1342,314,0.23397913561848,25th-50th percentile
186,06015,California,Del Norte,527,591,49,64,15,0.234375,25th-50th percentile
187,06023,California,Humboldt,2256,2511,107,255,148,0.580392156862745,Top 25th percentile
188,06105,California,Trinity,284,292,21,8,-13,-1.625,Bottom 25th percentile
189,06017,California,El Dorado,2769,3157,215,388,173,0.445876288659794,Top 25th percentile
190,06019,California,Fresno,12194,15224,2112,3030,918,0.302970297029703,50th-75th percentile
191,06021,California,Glenn,459,505,74,46,-28,-0.608695652173913,Bottom 25th percentile
192,06103,California,Tehama,1227,1460,143,233,90,0.386266094420601,50th-75th percentile
193,06025,California,Imperial,1956,3015,811,1059,248,0.234183191690274,25th-50th percentile
194,06029,California,Kern,10460,13269,1770,2809,1039,0.369882520469918,50th-75th percentile
195,06031,California,Kings,1507,1970,298,463,165,0.356371490280778,50th-75th percentile
196,06035,California,Lassen,398,502,68,104,36,0.346153846153846,50th-75th percentile
197,06063,California,Plumas,399,461,29,62,33,0.532258064516129,Top 25th percentile
198,06091,California,Sierra,57,61,4,4,0,0.0,25th-50th percentile
199,06037,California,Los Angeles,112139,142293,24283,30154,5871,0.194700537242157,25th-50th percentile
200,06039,California,Madera,1918,2359,386,441,55,0.124716553287982,25th-50th percentile
201,06041,California,Marin,3378,3656,188,278,90,0.323741007194245,50th-75th percentile
202,06043,California,Mariposa,353,370,24,17,-7,-0.411764705882353,Bottom 25th percentile
203,06109,California,Tuolumne,1173,1378,128,205,77,0.375609756097561,50th-75th percentile
204,06045,California,Mendocino,1409,1692,88,283,195,0.68904593639576,Top 25th percentile
205,06047,California,Merced,3111,3876,584,765,181,0.236601307189543,25th-50th percentile
206,06049,California,Modoc,192,218,7,26,19,0.730769230769231,Top 25th percentile
207,06093,California,Siskiyou,973,1154,72,181,109,0.602209944751381,Top 25th percentile
208,06053,California,Monterey,4496,5226,605,730,125,0.171232876712329,25th-50th percentile
209,06055,California,Napa,2130,2223,107,93,-14,-0.150537634408602,Bottom 25th percentile
210,06057,California,Nevada,1817,1999,115,182,67,0.368131868131868,50th-75th percentile
211,06059,California,Orange,35695,42073,5741,6378,637,0.0998745688303543,25th-50th percentile
212,06061,California,Placer,5934,6410,416,476,60,0.126050420168067,25th-50th percentile
213,06065,California,Riverside,30310,38149,6162,7839,1677,0.213930348258706,25th-50th percentile
214,06067,California,Sacramento,20704,23181,2102,2477,375,0.151392813887767,25th-50th percentile
215,06069,California,San Benito,641,733,81,92,11,0.119565217391304,25th-50th percentile
216,06071,California,San Bernardino,25613,33383,5871,7770,1899,0.244401544401544,50th-75th percentile
217,06073,California,San Diego,38032,43398,4351,5366,1015,0.189153932165486,25th-50th percentile
218,06075,California,San Francisco,9896,10530,547,634,87,0.137223974763407,25th-50th percentile
219,06077,California,San Joaquin,9902,12135,1753,2233,480,0.214957456336767,25th-50th percentile
220,06079,California,San Luis Obispo,4256,4413,343,157,-186,-1.18471337579618,Bottom 25th percentile
221,06081,California,San Mateo,8385,8715,587,330,-257,-0.778787878787879,Bottom 25th percentile
222,06083,California,Santa Barbara,5569,6108,513,539,26,0.0482374768089054,25th-50th percentile
223,06085,California,Santa Clara,17851,19439,1864,1588,-276,-0.173803526448363,Bottom 25th percentile
224,06087,California,Santa Cruz,2953,3237,260,284,24,0.0845070422535211,25th-50th percentile
225,06089,California,Shasta,3858,4416,374,558,184,0.329749103942652,50th-75th percentile
226,06095,California,Solano,5984,6655,495,671,176,0.262295081967213,50th-75th percentile
227,06097,California,Sonoma,7095,7720,416,625,209,0.3344,50th-75th percentile
228,06099,California,Stanislaus,7635,9302,1361,1667,306,0.183563287342532,25th-50th percentile
229,06101,California,Sutter,1472,1639,190,167,-23,-0.137724550898204,Bottom 25th percentile
230,06107,California,Tulare,5454,6864,1071,1410,339,0.240425531914894,25th-50th percentile
231,06111,California,Ventura,10056,11746,1139,1690,551,0.32603550295858,50th-75th percentile
232,06113,California,Yolo,2354,2589,226,235,9,0.0382978723404255,25th-50th percentile
233,06115,California,Yuba,1146,1233,98,87,-11,-0.126436781609195,Bottom 25th percentile
234,08005,Colorado,Arapahoe,6702,7935,761,1233,472,0.382806163828062,50th-75th percentile
235,08015,Colorado,Chaffee,338,319,23,-19,-42,2.21052631578947,Top 25th percentile
236,08051,Colorado,Gunnison,119,140,12,21,9,0.428571428571429,Top 25th percentile
237,08065,Colorado,Lake,62,68,10,6,-4,-0.666666666666667,Bottom 25th percentile
238,08097,Colorado,Pitkin,88,112,14,24,10,0.416666666666667,Top 25th percentile
239,08109,Colorado,Saguache,78,111,5,33,28,0.848484848484848,Top 25th percentile
240,08027,Colorado,Custer,77,93,11,16,5,0.3125,50th-75th percentile
241,08043,Colorado,Fremont,969,1091,97,122,25,0.204918032786885,25th-50th percentile
242,08029,Colorado,Delta,681,782,83,101,18,0.178217821782178,25th-50th percentile
243,08085,Colorado,Montrose,749,867,88,118,30,0.254237288135593,50th-75th percentile
244,08031,Colorado,Denver,7905,8680,899,775,-124,-0.16,Bottom 25th percentile
245,08035,Colorado,Douglas,2560,3211,287,651,364,0.559139784946237,Top 25th percentile
246,08037,Colorado,Eagle,242,247,26,5,-21,-4.2,Bottom 25th percentile
247,08039,Colorado,Elbert,300,296,27,-4,-31,7.75,Top 25th percentile
248,08063,Colorado,Kit Carson,112,156,12,44,32,0.727272727272727,Top 25th percentile
249,08073,Colorado,Lincoln,100,102,10,2,-8,-4.0,Bottom 25th percentile
250,08121,Colorado,Washington,101,116,21,15,-6,-0.4,Bottom 25th percentile
251,08125,Colorado,Yuma,169,193,19,24,5,0.208333333333333,25th-50th percentile
252,08041,Colorado,El Paso,8181,9946,1040,1765,725,0.410764872521246,50th-75th percentile
253,08045,Colorado,Garfield,594,646,61,52,-9,-0.173076923076923,Bottom 25th percentile
254,08059,Colorado,Jefferson,19947,22698,2270,2751,481,0.174845510723373,25th-50th percentile
255,08067,Colorado,La Plata,591,700,47,109,62,0.568807339449541,Top 25th percentile
256,08083,Colorado,Montezuma,461,540,43,79,36,0.455696202531646,Top 25th percentile
257,08069,Colorado,Larimer,4110,4453,265,343,78,0.227405247813411,25th-50th percentile
258,08075,Colorado,Logan,374,483,87,109,22,0.201834862385321,25th-50th percentile
259,08087,Colorado,Morgan,465,541,85,76,-9,-0.118421052631579,Bottom 25th percentile
260,08095,Colorado,Phillips,89,128,3,39,36,0.923076923076923,Top 25th percentile
261,08115,Colorado,Sedgwick,59,71,8,12,4,0.333333333333333,50th-75th percentile
262,08077,Colorado,Mesa,2644,3076,298,432,134,0.310185185185185,50th-75th percentile
263,08049,Colorado,Grand,124,139,11,15,4,0.266666666666667,50th-75th percentile
264,08057,Colorado,Jackson,22,28,15,6,-9,-1.5,Bottom 25th percentile
265,08081,Colorado,Moffat,163,251,47,88,41,0.465909090909091,Top 25th percentile
266,08103,Colorado,Rio Blanco,87,105,5,18,13,0.722222222222222,Top 25th percentile
267,08107,Colorado,Routt,206,211,24,5,-19,-3.8,Bottom 25th percentile
268,08019,Colorado,Clear Creek,106,104,5,-2,-7,3.5,Top 25th percentile
269,08047,Colorado,Gilpin,55,57,7,2,-5,-2.5,Bottom 25th percentile
270,08093,Colorado,Park,162,194,13,32,19,0.59375,Top 25th percentile
271,08117,Colorado,Summit,125,135,13,10,-3,-0.3,Bottom 25th percentile
272,08119,Colorado,Teller,321,393,26,72,46,0.638888888888889,Top 25th percentile
273,08101,Colorado,Pueblo,3130,3841,453,711,258,0.362869198312236,50th-75th percentile
274,08009,Colorado,Baca,90,131,5,41,36,0.878048780487805,Top 25th percentile
275,08011,Colorado,Bent,104,130,15,26,11,0.423076923076923,Top 25th percentile
276,08017,Colorado,Cheyenne,32,37,9,5,-4,-0.8,Bottom 25th percentile
277,08021,Colorado,Conejos,140,179,39,39,0,0.0,25th-50th percentile
278,08023,Colorado,Costilla,68,72,15,4,-11,-2.75,Bottom 25th percentile
279,08025,Colorado,Crowley,79,111,11,32,21,0.65625,Top 25th percentile
280,08055,Colorado,Huerfano,182,240,17,58,41,0.706896551724138,Top 25th percentile
281,08061,Colorado,Kiowa,36,30,6,-6,-12,2.0,Top 25th percentile
282,08071,Colorado,Las Animas,302,348,20,46,26,0.565217391304348,Top 25th percentile
283,08089,Colorado,Otero,406,508,66,102,36,0.352941176470588,50th-75th percentile
284,08099,Colorado,Prowers,225,294,31,69,38,0.550724637681159,Top 25th percentile
285,08003,Colorado,Alamosa,251,263,38,12,-26,-2.16666666666667,Bottom 25th percentile
286,08007,Colorado,Archuleta,186,203,6,17,11,0.647058823529412,Top 25th percentile
287,08033,Colorado,Dolores,41,57,15,16,1,0.0625,25th-50th percentile
288,08053,Colorado,Hinsdale,19,4,4,-15,-19,1.26666666666667,Top 25th percentile
289,08079,Colorado,Mineral,19,14,14,-5,-19,3.8,Top 25th percentile
290,08091,Colorado,Ouray,47,47,13,0,-13,-inf,Bottom 25th percentile
291,08105,Colorado,Rio Grande,220,264,19,44,25,0.568181818181818,Top 25th percentile
292,08111,Colorado,San Juan,14,8,8,-6,-14,2.33333333333333,Top 25th percentile
293,08113,Colorado,San Miguel,44,45,3,1,-2,-2.0,Bottom 25th percentile
294,09001,Connecticut,Fairfield,12000,13940,2084,1940,-144,-0.0742268041237113,Bottom 25th percentile
295,09003,Connecticut,Hartford,14069,15937,2323,1868,-455,-0.243576017130621,Bottom 25th percentile
296,09005,Connecticut,Litchfield,3168,3593,346,425,79,0.185882352941176,25th-50th percentile
297,09007,Connecticut,Middlesex,2720,2959,323,239,-84,-0.351464435146444,Bottom 25th percentile
298,09009,Connecticut,New Haven,13538,15322,2065,1784,-281,-0.157511210762332,Bottom 25th percentile
299,09011,Connecticut,New London,4268,4738,467,470,3,0.0063829787234042,25th-50th percentile
300,09013,Connecticut,Tolland,1896,2076,184,180,-4,-0.0222222222222222,25th-50th percentile
301,09015,Connecticut,Windham,1875,2081,193,206,13,0.0631067961165049,25th-50th percentile
302,10001,Delaware,Kent,2953,3613,388,660,272,0.412121212121212,50th-75th percentile
303,10003,Delaware,New Castle,8282,9528,915,1246,331,0.265650080256822,50th-75th percentile
304,10005,Delaware,Sussex,4874,5601,591,727,136,0.18707015130674,25th-50th percentile
305,11001,District of Columbia,District of Columbia,8407,9674,1238,1267,29,0.0228887134964483,25th-50th percentile
306,12001,Florida,Alachua,3458,3996,418,538,120,0.223048327137546,25th-50th percentile
307,12003,Florida,Baker,467,575,116,108,-8,-0.0740740740740741,Bottom 25th percentile
308,12007,Florida,Bradford,566,654,105,88,-17,-0.193181818181818,Bottom 25th percentile
309,12125,Florida,Union,421,481,85,60,-25,-0.416666666666667,Bottom 25th percentile
310,12005,Florida,Bay,3151,4006,587,855,268,0.313450292397661,50th-75th percentile
311,12009,Florida,Brevard,13140,15012,1513,1872,359,0.191773504273504,25th-50th percentile
312,12011,Florida,Broward,26421,31096,4260,4675,415,0.0887700534759358,25th-50th percentile
313,12015,Florida,Charlotte,5045,5743,615,698,83,0.1189111747851,25th-50th percentile
314,12017,Florida,Citrus,4713,5849,667,1136,469,0.412852112676056,Top 25th percentile
315,12019,Florida,Clay,3240,4206,613,966,353,0.365424430641822,50th-75th percentile
316,12021,Florida,Collier,6212,7243,798,1031,233,0.225994180407371,25th-50th percentile
317,12023,Florida,Columbia,1439,1830,272,391,119,0.304347826086957,50th-75th percentile
318,12027,Florida,DeSoto,649,794,128,145,17,0.117241379310345,25th-50th percentile
319,12049,Florida,Hardee,378,521,94,143,49,0.342657342657343,50th-75th percentile
320,12029,Florida,Dixie,398,467,60,69,9,0.130434782608696,25th-50th percentile
321,12041,Florida,Gilchrist,366,449,52,83,31,0.373493975903614,50th-75th percentile
322,12075,Florida,Levy,977,1203,138,226,88,0.389380530973451,50th-75th percentile
323,12031,Florida,Duval,14481,17978,2493,3497,1004,0.28710323134115,50th-75th percentile
324,12033,Florida,Escambia,6159,7395,863,1236,373,0.301779935275081,50th-75th percentile
325,12035,Florida,Flagler,2569,2957,261,388,127,0.327319587628866,50th-75th percentile
326,12039,Florida,Gadsden,816,1058,147,242,95,0.392561983471074,50th-75th percentile
327,12073,Florida,Leon,3454,4307,452,853,401,0.47010550996483,Top 25th percentile
328,12043,Florida,Glades,221,266,32,45,13,0.288888888888889,50th-75th percentile
329,12051,Florida,Hendry,542,702,128,160,32,0.2,25th-50th percentile
330,12093,Florida,Okeechobee,816,1033,152,217,65,0.299539170506912,50th-75th percentile
331,12047,Florida,Hamilton,297,348,51,51,0,0.0,25th-50th percentile
332,12067,Florida,Lafayette,137,208,38,71,33,0.464788732394366,Top 25th percentile
333,12121,Florida,Suwannee,1014,1251,225,237,12,0.0506329113924051,25th-50th percentile
334,12053,Florida,Hernando,5062,5828,743,766,23,0.0300261096605744,25th-50th percentile
335,12055,Florida,Highlands,2871,3478,454,607,153,0.252059308072488,50th-75th percentile
336,12057,Florida,Hillsborough,19179,22819,2642,3640,998,0.274175824175824,50th-75th percentile
337,12059,Florida,Holmes,493,598,74,105,31,0.295238095238095,50th-75th percentile
338,12131,Florida,Walton,1313,1434,167,121,-46,-0.380165289256198,Bottom 25th percentile
339,12061,Florida,Indian River,3786,4421,489,635,146,0.22992125984252,25th-50th percentile
340,12063,Florida,Jackson,1085,1328,194,243,49,0.201646090534979,25th-50th percentile
341,12133,Florida,Washington,616,664,82,48,-34,-0.708333333333333,Bottom 25th percentile
342,12065,Florida,Jefferson,324,397,45,73,28,0.383561643835616,50th-75th percentile
343,12079,Florida,Madison,412,534,85,122,37,0.30327868852459,50th-75th percentile
344,12123,Florida,Taylor,439,583,77,144,67,0.465277777777778,Top 25th percentile
345,12069,Florida,Lake,7866,9239,1033,1373,340,0.247632920611799,50th-75th percentile
346,12071,Florida,Lee,13111,15226,1577,2115,538,0.254373522458629,50th-75th percentile
347,12013,Florida,Calhoun,323,392,62,69,7,0.101449275362319,25th-50th percentile
348,12037,Florida,Franklin,285,306,43,21,-22,-1.04761904761905,Bottom 25th percentile
349,12045,Florida,Gulf,304,416,52,112,60,0.535714285714286,Top 25th percentile
350,12077,Florida,Liberty,125,175,30,50,20,0.4,50th-75th percentile
351,12129,Florida,Wakulla,526,703,89,177,88,0.497175141242938,Top 25th percentile
352,12081,Florida,Manatee,7440,8679,1055,1239,184,0.148506860371267,25th-50th percentile
353,12083,Florida,Marion,9042,11099,1513,2057,544,0.264462809917355,50th-75th percentile
354,12085,Florida,Martin,3431,4125,375,694,319,0.459654178674352,Top 25th percentile
355,12086,Florida,Miami-Dade,35500,45243,7552,9743,2191,0.224879400595299,25th-50th percentile
356,12087,Florida,Monroe,1160,1352,91,192,101,0.526041666666667,Top 25th percentile
357,12089,Florida,Nassau,1678,1944,235,266,31,0.116541353383459,25th-50th percentile
358,12091,Florida,Okaloosa,3275,3858,483,583,100,0.171526586620926,25th-50th percentile
359,12095,Florida,Orange,14584,17230,2129,2646,517,0.195389266817838,25th-50th percentile
360,12097,Florida,Osceola,4410,5551,848,1141,293,0.256792287467134,50th-75th percentile
361,12099,Florida,Palm Beach,25772,29927,3474,4155,681,0.163898916967509,25th-50th percentile
362,12101,Florida,Pasco,11489,13010,1359,1521,162,0.106508875739645,25th-50th percentile
363,12103,Florida,Pinellas,20793,22919,1917,2126,209,0.0983066792097836,25th-50th percentile
364,12105,Florida,Polk,13035,15865,2211,2830,619,0.218727915194346,25th-50th percentile
365,12107,Florida,Putnam,1733,2309,332,576,244,0.423611111111111,Top 25th percentile
366,12109,Florida,St. Johns,3910,4267,391,357,-34,-0.0952380952380952,Bottom 25th percentile
367,12111,Florida,St. Lucie,6113,7221,864,1108,244,0.220216606498195,25th-50th percentile
368,12113,Florida,Santa Rosa,2911,3376,449,465,16,0.0344086021505376,25th-50th percentile
369,12115,Florida,Sarasota,10503,12003,1045,1500,455,0.303333333333333,50th-75th percentile
370,12117,Florida,Seminole,6195,7044,755,849,94,0.110718492343934,25th-50th percentile
371,12119,Florida,Sumter,3633,4416,431,783,352,0.449553001277139,Top 25th percentile
372,12127,Florida,Volusia,12971,14800,1491,1829,338,0.184800437397485,25th-50th percentile
373,13001,Georgia,Appling,372,471,105,99,-6,-0.0606060606060606,Bottom 25th percentile
374,13161,Georgia,Jeff Davis,310,375,56,65,9,0.138461538461538,25th-50th percentile
375,13183,Georgia,Long,189,224,29,35,6,0.171428571428571,25th-50th percentile
376,13305,Georgia,Wayne,608,803,141,195,54,0.276923076923077,50th-75th percentile
377,13005,Georgia,Bacon,267,304,64,37,-27,-0.72972972972973,Bottom 25th percentile
378,13017,Georgia,Ben Hill,395,509,87,114,27,0.236842105263158,25th-50th percentile
379,13069,Georgia,Coffee,724,966,200,242,42,0.173553719008264,25th-50th percentile
380,13155,Georgia,Irwin,200,258,45,58,13,0.224137931034483,25th-50th percentile
381,13011,Georgia,Banks,335,409,54,74,20,0.27027027027027,50th-75th percentile
382,13137,Georgia,Habersham,829,1044,161,215,54,0.251162790697674,50th-75th percentile
383,13013,Georgia,Barrow,1158,1384,167,226,59,0.261061946902655,50th-75th percentile
384,13015,Georgia,Bartow,1660,2146,282,486,204,0.419753086419753,Top 25th percentile
385,13021,Georgia,Bibb,3009,3839,514,830,316,0.380722891566265,50th-75th percentile
386,13023,Georgia,Bleckley,295,346,71,51,-20,-0.392156862745098,Bottom 25th percentile
387,13091,Georgia,Dodge,391,565,126,174,48,0.275862068965517,50th-75th percentile
388,13235,Georgia,Pulaski,206,270,53,64,11,0.171875,25th-50th percentile
389,13289,Georgia,Twiggs,193,271,44,78,34,0.435897435897436,Top 25th percentile
390,13025,Georgia,Brantley,366,464,93,98,5,0.0510204081632653,25th-50th percentile
391,13229,Georgia,Pierce,396,546,110,150,40,0.266666666666667,50th-75th percentile
392,13299,Georgia,Ware,846,1076,210,230,20,0.0869565217391304,25th-50th percentile
393,13027,Georgia,Brooks,363,419,63,56,-7,-0.125,Bottom 25th percentile
394,13275,Georgia,Thomas,958,1159,160,201,41,0.203980099502488,25th-50th percentile
395,13029,Georgia,Bryan,519,601,72,82,10,0.121951219512195,25th-50th percentile
396,13179,Georgia,Liberty,646,892,132,246,114,0.463414634146342,Top 25th percentile
397,13031,Georgia,Bulloch,995,1190,191,195,4,0.0205128205128205,25th-50th percentile
398,13033,Georgia,Burke,422,504,76,82,6,0.0731707317073171,25th-50th percentile
399,13107,Georgia,Emanuel,528,676,126,148,22,0.148648648648649,25th-50th percentile
400,13165,Georgia,Jenkins,178,220,46,42,-4,-0.0952380952380952,Bottom 25th percentile
401,13251,Georgia,Screven,324,401,59,77,18,0.233766233766234,25th-50th percentile
402,13035,Georgia,Butts,483,597,91,114,23,0.201754385964912,25th-50th percentile
403,13171,Georgia,Lamar,388,496,80,108,28,0.259259259259259,50th-75th percentile
404,13207,Georgia,Monroe,496,644,105,148,43,0.290540540540541,50th-75th percentile
405,13007,Georgia,Baker,61,75,8,14,6,0.428571428571429,Top 25th percentile
406,13037,Georgia,Calhoun,119,130,4,11,7,0.636363636363636,Top 25th percentile
407,13061,Georgia,Clay,77,72,7,-5,-12,2.4,Top 25th percentile
408,13099,Georgia,Early,278,333,56,55,-1,-0.0181818181818182,25th-50th percentile
409,13177,Georgia,Lee,419,533,72,114,42,0.368421052631579,50th-75th percentile
410,13201,Georgia,Miller,160,204,21,44,23,0.522727272727273,Top 25th percentile
411,13239,Georgia,Quitman,61,77,10,16,6,0.375,50th-75th percentile
412,13243,Georgia,Randolph,166,210,31,44,13,0.295454545454545,50th-75th percentile
413,13273,Georgia,Terrell,208,254,46,46,0,0.0,25th-50th percentile
414,13039,Georgia,Camden,675,813,100,138,38,0.27536231884058,50th-75th percentile
415,13049,Georgia,Charlton,201,290,60,89,29,0.325842696629214,50th-75th percentile
416,13043,Georgia,Candler,284,379,76,95,19,0.2,25th-50th percentile
417,13109,Georgia,Evans,197,276,42,79,37,0.468354430379747,Top 25th percentile
418,13267,Georgia,Tattnall,419,544,104,125,21,0.168,25th-50th percentile
419,13279,Georgia,Toombs,542,790,140,248,108,0.435483870967742,Top 25th percentile
420,13045,Georgia,Carroll,1988,2422,323,434,111,0.255760368663595,50th-75th percentile
421,13149,Georgia,Heard,228,273,31,45,14,0.311111111111111,50th-75th percentile
422,13047,Georgia,Catoosa,1174,1454,196,280,84,0.3,50th-75th percentile
423,13051,Georgia,Chatham,4257,5177,581,920,339,0.368478260869565,50th-75th percentile
424,13055,Georgia,Chattooga,564,653,77,89,12,0.134831460674157,25th-50th percentile
425,13083,Georgia,Dade,336,416,29,80,51,0.6375,Top 25th percentile
426,13295,Georgia,Walker,1508,1684,203,176,-27,-0.153409090909091,Bottom 25th percentile
427,13057,Georgia,Cherokee,2914,3533,360,619,259,0.418416801292407,Top 25th percentile
428,13227,Georgia,Pickens,617,757,101,140,39,0.278571428571429,50th-75th percentile
429,13059,Georgia,Clarke,1384,1535,134,151,17,0.112582781456954,25th-50th percentile
430,13195,Georgia,Madison,533,626,75,93,18,0.193548387096774,25th-50th percentile
431,13219,Georgia,Oconee,505,592,55,87,32,0.367816091954023,50th-75th percentile
432,13063,Georgia,Clayton,3057,4055,604,998,394,0.394789579158317,50th-75th percentile
433,13067,Georgia,Cobb,7811,9270,1029,1459,430,0.294722412611378,50th-75th percentile
434,13071,Georgia,Colquitt,861,1090,160,229,69,0.301310043668122,50th-75th percentile
435,13205,Georgia,Mitchell,453,559,84,106,22,0.207547169811321,25th-50th percentile
436,13073,Georgia,Columbia,1764,2182,265,418,153,0.366028708133971,50th-75th percentile
437,13077,Georgia,Coweta,1943,2467,324,524,200,0.381679389312977,50th-75th percentile
438,13079,Georgia,Crawford,229,323,33,94,61,0.648936170212766,Top 25th percentile
439,13225,Georgia,Peach,567,673,99,106,7,0.0660377358490566,25th-50th percentile
440,13231,Georgia,Pike,369,413,81,44,-37,-0.840909090909091,Bottom 25th percentile
441,13293,Georgia,Upson,693,913,148,220,72,0.327272727272727,50th-75th percentile
442,13081,Georgia,Crisp,447,642,109,195,86,0.441025641025641,Top 25th percentile
443,13093,Georgia,Dooly,218,318,45,100,55,0.55,Top 25th percentile
444,13287,Georgia,Turner,217,224,40,7,-33,-4.71428571428571,Bottom 25th percentile
445,13315,Georgia,Wilcox,173,268,42,95,53,0.557894736842105,Top 25th percentile
446,13085,Georgia,Dawson,444,507,69,63,-6,-0.0952380952380952,Bottom 25th percentile
447,13187,Georgia,Lumpkin,524,646,85,122,37,0.30327868852459,50th-75th percentile
448,13311,Georgia,White,544,715,95,171,76,0.444444444444444,Top 25th percentile
449,13087,Georgia,Decatur,561,704,86,143,57,0.398601398601399,50th-75th percentile
450,13131,Georgia,Grady,454,561,84,107,23,0.214953271028037,25th-50th percentile
451,13253,Georgia,Seminole,224,269,41,45,4,0.0888888888888889,25th-50th percentile
452,13089,Georgia,DeKalb,8027,9597,993,1570,577,0.367515923566879,50th-75th percentile
453,13095,Georgia,Dougherty,1632,2123,315,491,176,0.358452138492872,50th-75th percentile
454,13097,Georgia,Douglas,1746,2186,258,440,182,0.413636363636364,Top 25th percentile
455,13103,Georgia,Effingham,856,1034,172,178,6,0.0337078651685393,25th-50th percentile
456,13105,Georgia,Elbert,459,607,63,148,85,0.574324324324324,Top 25th percentile
457,13119,Georgia,Franklin,536,645,73,109,36,0.330275229357798,50th-75th percentile
458,13147,Georgia,Hart,547,657,86,110,24,0.218181818181818,25th-50th percentile
459,13257,Georgia,Stephens,654,759,103,105,2,0.0190476190476191,25th-50th percentile
460,13111,Georgia,Fannin,599,737,92,138,46,0.333333333333333,50th-75th percentile
461,13241,Georgia,Rabun,371,488,57,117,60,0.512820512820513,Top 25th percentile
462,13281,Georgia,Towns,342,408,63,66,3,0.0454545454545455,25th-50th percentile
463,13291,Georgia,Union,580,760,94,180,86,0.477777777777778,Top 25th percentile
464,13113,Georgia,Fayette,1605,1932,207,327,120,0.36697247706422,50th-75th percentile
465,13115,Georgia,Floyd,1984,2414,292,430,138,0.32093023255814,50th-75th percentile
466,13117,Georgia,Forsyth,2223,2641,247,418,171,0.409090909090909,50th-75th percentile
467,13121,Georgia,Fulton,11872,13817,1504,1945,441,0.226735218508997,25th-50th percentile
468,13123,Georgia,Gilmer,632,796,122,164,42,0.25609756097561,50th-75th percentile
469,13213,Georgia,Murray,670,861,120,191,71,0.3717277486911,50th-75th percentile
470,13127,Georgia,Glynn,1547,1983,291,436,145,0.33256880733945,50th-75th percentile
471,13191,Georgia,McIntosh,278,333,37,55,18,0.327272727272727,50th-75th percentile
472,13129,Georgia,Gordon,1019,1278,172,259,87,0.335907335907336,50th-75th percentile
473,13135,Georgia,Gwinnett,7766,9782,1220,2016,796,0.39484126984127,50th-75th percentile
474,13139,Georgia,Hall,2761,3433,476,672,196,0.291666666666667,50th-75th percentile
475,13141,Georgia,Hancock,187,314,69,127,58,0.456692913385827,Top 25th percentile
476,13159,Georgia,Jasper,292,350,66,58,-8,-0.137931034482759,Bottom 25th percentile
477,13211,Georgia,Morgan,353,452,43,99,56,0.565656565656566,Top 25th percentile
478,13237,Georgia,Putnam,436,563,76,127,51,0.401574803149606,50th-75th percentile
479,13143,Georgia,Haralson,628,766,113,138,25,0.181159420289855,25th-50th percentile
480,13233,Georgia,Polk,846,1047,131,201,70,0.348258706467662,50th-75th percentile
481,13145,Georgia,Harris,531,576,86,45,-41,-0.911111111111111,Bottom 25th percentile
482,13199,Georgia,Meriwether,482,650,85,168,83,0.494047619047619,Top 25th percentile
483,13263,Georgia,Talbot,149,165,21,16,-5,-0.3125,Bottom 25th percentile
484,13151,Georgia,Henry,2887,3592,448,705,257,0.364539007092199,50th-75th percentile
485,13153,Georgia,Houston,2213,2810,341,597,256,0.428810720268007,Top 25th percentile
486,13157,Georgia,Jackson,1157,1413,196,256,60,0.234375,25th-50th percentile
487,13003,Georgia,Atkinson,144,207,39,63,24,0.380952380952381,50th-75th percentile
488,13019,Georgia,Berrien,399,488,65,89,24,0.269662921348315,50th-75th percentile
489,13065,Georgia,Clinch,147,206,32,59,27,0.457627118644068,Top 25th percentile
490,13075,Georgia,Cook,343,406,60,63,3,0.0476190476190476,25th-50th percentile
491,13101,Georgia,Echols,46,75,8,29,21,0.724137931034483,Top 25th percentile
492,13173,Georgia,Lanier,172,180,13,8,-5,-0.625,Bottom 25th percentile
493,13185,Georgia,Lowndes,1653,2064,256,411,155,0.37712895377129,50th-75th percentile
494,13053,Georgia,Chattahoochee,78,64,13,-14,-27,1.92857142857143,Top 25th percentile
495,13193,Georgia,Macon,301,299,34,-2,-36,18.0,Top 25th percentile
496,13197,Georgia,Marion,151,209,31,58,27,0.46551724137931,Top 25th percentile
497,13249,Georgia,Schley,71,84,8,13,5,0.384615384615385,50th-75th percentile
498,13259,Georgia,Stewart,122,121,23,-1,-24,24.0,Top 25th percentile
499,13261,Georgia,Sumter,637,734,121,97,-24,-0.247422680412371,Bottom 25th percentile
500,13269,Georgia,Taylor,173,222,31,49,18,0.36734693877551,50th-75th percentile
501,13307,Georgia,Webster,45,45,11,0,-11,-inf,Bottom 25th percentile
502,13215,Georgia,Muscogee,3484,4171,536,687,151,0.219796215429403,25th-50th percentile
503,13217,Georgia,Newton,1593,2054,291,461,170,0.368763557483731,50th-75th percentile
504,13223,Georgia,Paulding,1746,2101,281,355,74,0.208450704225352,25th-50th percentile
505,13245,Georgia,Richmond,3513,4415,597,902,305,0.338137472283814,50th-75th percentile
506,13247,Georgia,Rockdale,1311,1625,204,314,110,0.35031847133758,50th-75th percentile
507,13255,Georgia,Spalding,1362,1792,283,430,147,0.341860465116279,50th-75th percentile
508,13133,Georgia,Greene,399,465,54,66,12,0.181818181818182,25th-50th percentile
509,13181,Georgia,Lincoln,168,206,32,38,6,0.157894736842105,25th-50th percentile
510,13189,Georgia,McDuffie,443,516,58,73,15,0.205479452054795,25th-50th percentile
511,13221,Georgia,Ogelthorpe,310,329,21,19,-2,-0.105263157894737,Bottom 25th percentile
512,13265,Georgia,Taliaferro,44,56,7,12,5,0.416666666666667,Top 25th percentile
513,13301,Georgia,Warren,134,162,18,28,10,0.357142857142857,50th-75th percentile
514,13317,Georgia,Wilkes,287,296,31,9,-22,-2.44444444444444,Bottom 25th percentile
515,13277,Georgia,Tift,811,938,146,127,-19,-0.149606299212598,Bottom 25th percentile
516,13321,Georgia,Worth,431,500,78,69,-9,-0.130434782608696,Bottom 25th percentile
517,13285,Georgia,Troup,1255,1580,253,325,72,0.221538461538462,25th-50th percentile
518,13297,Georgia,Walton,1584,2005,293,421,128,0.304038004750594,50th-75th percentile
519,13009,Georgia,Baldwin,838,1034,130,196,66,0.336734693877551,50th-75th percentile
520,13125,Georgia,Glascock,66,78,14,12,-2,-0.166666666666667,Bottom 25th percentile
521,13163,Georgia,Jefferson,395,507,75,112,37,0.330357142857143,50th-75th percentile
522,13167,Georgia,Johnson,192,255,49,63,14,0.222222222222222,25th-50th percentile
523,13169,Georgia,Jones,463,599,73,136,63,0.463235294117647,Top 25th percentile
524,13303,Georgia,Washington,420,580,110,160,50,0.3125,50th-75th percentile
525,13319,Georgia,Wilkinson,213,297,37,84,47,0.55952380952381,Top 25th percentile
526,13175,Georgia,Laurens,1000,1330,211,330,119,0.360606060606061,50th-75th percentile
527,13209,Georgia,Montgomery,164,229,44,65,21,0.323076923076923,50th-75th percentile
528,13271,Georgia,Telfair,305,363,64,58,-6,-0.103448275862069,Bottom 25th percentile
529,13283,Georgia,Treutlen,141,211,43,70,27,0.385714285714286,50th-75th percentile
530,13309,Georgia,Wheeler,114,135,24,21,-3,-0.142857142857143,Bottom 25th percentile
531,13313,Georgia,Whitfield,1537,1911,319,374,55,0.147058823529412,25th-50th percentile
532,15001,Hawaii,Hawaii (county),3108,3331,136,223,87,0.390134529147982,50th-75th percentile
533,15003,Hawaii,Honolulu,13356,14665,704,1309,605,0.46218487394958,Top 25th percentile
534,15005,Hawaii,Kalawao,1,4,4,3,-1,-0.333333333333333,Bottom 25th percentile
535,15009,Hawaii,Maui,2052,2244,93,192,99,0.515625,Top 25th percentile
536,15007,Hawaii,Kauai,1011,991,16,-20,-36,1.8,Top 25th percentile
537,16001,Idaho,Ada,5782,6728,698,946,248,0.26215644820296,50th-75th percentile
538,16005,Idaho,Bannock,1282,1487,159,205,46,0.224390243902439,25th-50th percentile
539,16007,Idaho,Bear Lake,103,139,16,36,20,0.555555555555556,Top 25th percentile
540,16029,Idaho,Caribou,118,139,20,21,1,0.0476190476190476,25th-50th percentile
541,16041,Idaho,Franklin,190,194,17,4,-13,-3.25,Bottom 25th percentile
542,16009,Idaho,Benewah,223,234,24,11,-13,-1.18181818181818,Bottom 25th percentile
543,16057,Idaho,Latah,374,467,28,93,65,0.698924731182796,Top 25th percentile
544,16069,Idaho,Nez Perce,878,960,80,82,2,0.024390243902439,25th-50th percentile
545,16011,Idaho,Bingham,689,825,106,136,30,0.220588235294118,25th-50th percentile
546,16071,Idaho,Oneida,74,91,10,17,7,0.411764705882353,50th-75th percentile
547,16077,Idaho,Power,106,139,13,33,20,0.606060606060606,Top 25th percentile
548,16015,Idaho,Boise,104,127,6,23,17,0.739130434782609,Top 25th percentile
549,16045,Idaho,Gem,395,481,46,86,40,0.465116279069768,Top 25th percentile
550,16075,Idaho,Payette,426,509,64,83,19,0.228915662650602,25th-50th percentile
551,16087,Idaho,Washington,215,274,38,59,21,0.355932203389831,50th-75th percentile
552,16017,Idaho,Bonner,824,884,95,60,-35,-0.583333333333333,Bottom 25th percentile
553,16021,Idaho,Boundary,206,263,28,57,29,0.508771929824562,Top 25th percentile
554,16079,Idaho,Shoshone,346,375,59,29,-30,-1.03448275862069,Bottom 25th percentile
555,16019,Idaho,Bonneville,1637,1819,200,182,-18,-0.0989010989010989,Bottom 25th percentile
556,16027,Idaho,Canyon,2929,3390,493,461,-32,-0.06941431670282,Bottom 25th percentile
557,16003,Idaho,Adams,72,83,7,11,4,0.363636363636364,50th-75th percentile
558,16035,Idaho,Clearwater,186,217,18,31,13,0.419354838709677,Top 25th percentile
559,16037,Idaho,Custer,94,102,6,8,2,0.25,50th-75th percentile
560,16049,Idaho,Idaho (county),347,395,38,48,10,0.208333333333333,25th-50th percentile
561,16059,Idaho,Lemhi,181,231,12,50,38,0.76,Top 25th percentile
562,16061,Idaho,Lewis,85,92,19,7,-12,-1.71428571428571,Bottom 25th percentile
563,16085,Idaho,Valley,152,159,5,7,2,0.285714285714286,50th-75th percentile
564,16039,Idaho,Elmore,375,402,47,27,-20,-0.740740740740741,Bottom 25th percentile
565,16047,Idaho,Gooding,238,305,43,67,24,0.358208955223881,50th-75th percentile
566,16073,Idaho,Owyhee,177,240,33,63,30,0.476190476190476,Top 25th percentile
567,16023,Idaho,Butte,53,57,5,4,-1,-0.25,Bottom 25th percentile
568,16033,Idaho,Clark,11,16,10,5,-5,-1.0,Bottom 25th percentile
569,16043,Idaho,Fremont,191,239,18,48,30,0.625,Top 25th percentile
570,16051,Idaho,Jefferson,326,359,43,33,-10,-0.303030303030303,Bottom 25th percentile
571,16065,Idaho,Madison,305,354,30,49,19,0.387755102040816,50th-75th percentile
572,16081,Idaho,Teton,87,90,14,3,-11,-3.66666666666667,Bottom 25th percentile
573,16055,Idaho,Kootenai,2787,3048,349,261,-88,-0.337164750957854,Bottom 25th percentile
574,16013,Idaho,Blaine,208,244,26,36,10,0.277777777777778,50th-75th percentile
575,16025,Idaho,Camas,22,17,7,-5,-12,2.4,Top 25th percentile
576,16031,Idaho,Cassia,352,375,34,23,-11,-0.478260869565217,Bottom 25th percentile
577,16053,Idaho,Jerome,312,351,52,39,-13,-0.333333333333333,Bottom 25th percentile
578,16063,Idaho,Lincoln,66,72,6,6,0,0.0,25th-50th percentile
579,16067,Idaho,Minidoka,345,362,47,17,-30,-1.76470588235294,Bottom 25th percentile
580,16083,Idaho,Twin Falls,1330,1605,197,275,78,0.283636363636364,50th-75th percentile
581,17001,Illinois,Adams,1398,1547,148,149,1,0.0067114093959731,25th-50th percentile
582,17005,Illinois,Bond,321,348,33,27,-6,-0.222222222222222,Bottom 25th percentile
583,17049,Illinois,Effingham,631,766,85,135,50,0.37037037037037,50th-75th percentile
584,17051,Illinois,Fayette,400,443,51,43,-8,-0.186046511627907,Bottom 25th percentile
585,17007,Illinois,Boone,740,826,80,86,6,0.0697674418604651,25th-50th percentile
586,17009,Illinois,Brown,104,119,10,15,5,0.333333333333333,50th-75th percentile
587,17013,Illinois,Calhoun,92,110,7,18,11,0.611111111111111,Top 25th percentile
588,17017,Illinois,Cass,245,271,43,26,-17,-0.653846153846154,Bottom 25th percentile
589,17149,Illinois,Pike,365,435,66,70,4,0.0571428571428571,25th-50th percentile
590,17169,Illinois,Schuyler,160,178,7,18,11,0.611111111111111,Top 25th percentile
591,17171,Illinois,Scott,105,110,10,5,-5,-1.0,Bottom 25th percentile
592,17011,Illinois,Bureau,691,761,89,70,-19,-0.271428571428571,Bottom 25th percentile
593,17123,Illinois,Marshall,312,301,20,-11,-31,2.81818181818182,Top 25th percentile
594,17155,Illinois,Putnam,102,96,14,-6,-20,3.33333333333333,Top 25th percentile
595,17175,Illinois,Stark,128,155,16,27,11,0.407407407407407,50th-75th percentile
596,17015,Illinois,Carroll,332,392,36,60,24,0.4,50th-75th percentile
597,17085,Illinois,Jo Daviess,409,472,37,63,26,0.412698412698413,Top 25th percentile
598,17177,Illinois,Stephenson,932,1102,116,170,54,0.317647058823529,50th-75th percentile
599,17019,Illinois,Champaign,2305,2632,169,327,158,0.483180428134557,Top 25th percentile
600,17021,Illinois,Christian,734,838,90,104,14,0.134615384615385,25th-50th percentile
601,17173,Illinois,Shelby,419,474,57,55,-2,-0.0363636363636364,25th-50th percentile
602,17023,Illinois,Clark,337,394,43,57,14,0.245614035087719,50th-75th percentile
603,17033,Illinois,Crawford,387,415,51,28,-23,-0.821428571428571,Bottom 25th percentile
604,17035,Illinois,Cumberland,205,250,34,45,11,0.244444444444444,50th-75th percentile
605,17079,Illinois,Jasper,172,194,23,22,-1,-0.0454545454545455,Bottom 25th percentile
606,17025,Illinois,Clay,329,329,41,0,-41,-inf,Bottom 25th percentile
607,17065,Illinois,Hamilton,186,211,26,25,-1,-0.04,25th-50th percentile
608,17191,Illinois,Wayne,356,421,58,65,7,0.107692307692308,25th-50th percentile
609,17193,Illinois,White,393,434,51,41,-10,-0.24390243902439,Bottom 25th percentile
610,17027,Illinois,Clinton,614,682,69,68,-1,-0.0147058823529412,25th-50th percentile
611,17121,Illinois,Marion,887,1072,98,185,87,0.47027027027027,Top 25th percentile
612,17029,Illinois,Coles,895,1054,99,159,60,0.377358490566038,50th-75th percentile
613,17031,Illinois,Cook,69793,83055,10832,13262,2430,0.183230282008747,25th-50th percentile
614,17037,Illinois,DeKalb,1282,1487,104,205,101,0.492682926829268,Top 25th percentile
615,17039,Illinois,De Witt,355,406,38,51,13,0.254901960784314,50th-75th percentile
616,17107,Illinois,Logan,620,659,74,39,-35,-0.897435897435897,Bottom 25th percentile
617,17125,Illinois,Mason,337,393,51,56,5,0.0892857142857143,25th-50th percentile
618,17129,Illinois,Menard,214,240,26,26,0,0.0,25th-50th percentile
619,17041,Illinois,Douglas,350,406,42,56,14,0.25,50th-75th percentile
620,17045,Illinois,Edgar,405,467,62,62,0,0.0,25th-50th percentile
621,17139,Illinois,Moultrie,352,377,27,25,-2,-0.08,Bottom 25th percentile
622,17147,Illinois,Piatt,308,347,7,39,32,0.82051282051282,Top 25th percentile
623,17043,Illinois,DuPage,11145,12637,1120,1492,372,0.249329758713137,50th-75th percentile
624,17047,Illinois,Edwards,129,155,24,26,2,0.0769230769230769,25th-50th percentile
625,17101,Illinois,Lawrence,343,349,42,6,-36,-6.0,Bottom 25th percentile
626,17159,Illinois,Richland,355,442,62,87,25,0.28735632183908,50th-75th percentile
627,17185,Illinois,Wabash,229,275,29,46,17,0.369565217391304,50th-75th percentile
628,17053,Illinois,Ford,348,408,43,60,17,0.283333333333333,50th-75th percentile
629,17075,Illinois,Iroquois,643,731,69,88,19,0.215909090909091,25th-50th percentile
630,17105,Illinois,Livingston,758,819,100,61,-39,-0.639344262295082,Bottom 25th percentile
631,17055,Illinois,Franklin,874,1081,133,207,74,0.357487922705314,50th-75th percentile
632,17059,Illinois,Gallatin,128,154,2,26,24,0.923076923076923,Top 25th percentile
633,17165,Illinois,Saline,628,715,86,87,1,0.0114942528735632,25th-50th percentile
634,17057,Illinois,Fulton,818,933,80,115,35,0.304347826086957,50th-75th percentile
635,17109,Illinois,McDonough,556,600,57,44,-13,-0.295454545454545,Bottom 25th percentile
636,17061,Illinois,Greene,293,332,44,39,-5,-0.128205128205128,Bottom 25th percentile
637,17083,Illinois,Jersey,476,531,54,55,1,0.0181818181818182,25th-50th percentile
638,17137,Illinois,Morgan,719,780,81,61,-20,-0.327868852459016,Bottom 25th percentile
639,17063,Illinois,Grundy,738,895,83,157,74,0.471337579617834,Top 25th percentile
640,17067,Illinois,Hancock,364,444,50,80,30,0.375,50th-75th percentile
641,17071,Illinois,Henderson,147,178,22,31,9,0.290322580645161,50th-75th percentile
642,17131,Illinois,Mercer,352,375,29,23,-6,-0.260869565217391,Bottom 25th percentile
643,17187,Illinois,Warren,340,413,55,73,18,0.246575342465753,50th-75th percentile
644,17073,Illinois,Henry,932,1096,83,164,81,0.49390243902439,Top 25th percentile
645,17077,Illinois,Jackson,817,1047,121,230,109,0.473913043478261,Top 25th percentile
646,17081,Illinois,Jefferson,771,957,120,186,66,0.354838709677419,50th-75th percentile
647,17189,Illinois,Washington,282,296,35,14,-21,-1.5,Bottom 25th percentile
648,17089,Illinois,Kane,5820,6891,752,1071,319,0.297852474323063,50th-75th percentile
649,17091,Illinois,Kankakee,1985,2295,208,310,102,0.329032258064516,50th-75th percentile
650,17093,Illinois,Kendall,1068,1324,120,256,136,0.53125,Top 25th percentile
651,17095,Illinois,Knox,1182,1348,161,166,5,0.0301204819277108,25th-50th percentile
652,17097,Illinois,Lake,8222,9381,977,1159,182,0.157031924072476,25th-50th percentile
653,17099,Illinois,La Salle,2261,2530,269,269,0,0.0,25th-50th percentile
654,17103,Illinois,Lee,661,750,91,89,-2,-0.0224719101123596,25th-50th percentile
655,17195,Illinois,Whiteside,1186,1371,211,185,-26,-0.140540540540541,Bottom 25th percentile
656,17111,Illinois,McHenry,3713,4352,364,639,275,0.430359937402191,Top 25th percentile
657,17113,Illinois,McLean,2110,2396,220,286,66,0.230769230769231,25th-50th percentile
658,17115,Illinois,Macon,2157,2447,244,290,46,0.158620689655172,25th-50th percentile
659,17117,Illinois,Macoupin,958,1129,124,171,47,0.274853801169591,50th-75th percentile
660,17135,Illinois,Montgomery,615,743,90,128,38,0.296875,50th-75th percentile
661,17119,Illinois,Madison,4953,5716,550,763,213,0.27916120576671,50th-75th percentile
662,17133,Illinois,Monroe,552,629,75,77,2,0.025974025974026,25th-50th percentile
663,17163,Illinois,St. Clair,4470,5222,572,752,180,0.23936170212766,25th-50th percentile
664,17141,Illinois,Ogle,914,1023,80,109,29,0.26605504587156,50th-75th percentile
665,17143,Illinois,Peoria,3079,3545,307,466,159,0.341201716738197,50th-75th percentile
666,17203,Illinois,Woodford,672,753,93,81,-12,-0.148148148148148,Bottom 25th percentile
667,17145,Illinois,Perry,407,471,60,64,4,0.0625,25th-50th percentile
668,17157,Illinois,Randolph,622,755,93,133,40,0.300751879699248,50th-75th percentile
669,17161,Illinois,Rock Island,2753,3184,306,431,125,0.290023201856148,50th-75th percentile
670,17167,Illinois,Sangamon,3412,3614,295,202,-93,-0.46039603960396,Bottom 25th percentile
671,17003,Illinois,Alexander,153,196,23,43,20,0.465116279069768,Top 25th percentile
672,17069,Illinois,Hardin,113,140,13,27,14,0.518518518518519,Top 25th percentile
673,17087,Illinois,Johnson,234,295,45,61,16,0.262295081967213,50th-75th percentile
674,17127,Illinois,Massac,364,408,47,44,-3,-0.0681818181818182,Bottom 25th percentile
675,17151,Illinois,Pope,90,101,9,11,2,0.181818181818182,25th-50th percentile
676,17153,Illinois,Pulaski,140,159,19,19,0,0.0,25th-50th percentile
677,17181,Illinois,Union,403,478,47,75,28,0.373333333333333,50th-75th percentile
678,17179,Illinois,Tazewell,2457,2896,230,439,209,0.476082004555809,Top 25th percentile
679,17183,Illinois,Vermilion,1645,1933,199,288,89,0.309027777777778,50th-75th percentile
680,17197,Illinois,Will,8229,9699,980,1470,490,0.333333333333333,50th-75th percentile
681,17199,Illinois,Williamson,1301,1526,148,225,77,0.342222222222222,50th-75th percentile
682,17201,Illinois,Winnebago,5051,5812,496,761,265,0.348226018396846,50th-75th percentile
683,18001,Indiana,Adams,563,645,75,82,7,0.0853658536585366,25th-50th percentile
684,18179,Indiana,Wells,538,634,77,96,19,0.197916666666667,25th-50th percentile
685,18003,Indiana,Allen,5954,6603,685,649,-36,-0.0554699537750385,Bottom 25th percentile
686,18005,Indiana,Bartholomew,1326,1505,167,179,12,0.0670391061452514,25th-50th percentile
687,18013,Indiana,Brown,307,339,37,32,-5,-0.15625,Bottom 25th percentile
688,18007,Indiana,Benton,152,187,15,35,20,0.571428571428571,Top 25th percentile
689,18073,Indiana,Jasper,561,727,88,166,78,0.469879518072289,Top 25th percentile
690,18111,Indiana,Newton,307,339,45,32,-13,-0.40625,Bottom 25th percentile
691,18009,Indiana,Blackford,302,342,45,40,-5,-0.125,Bottom 25th percentile
692,18075,Indiana,Jay,408,463,59,55,-4,-0.0727272727272727,Bottom 25th percentile
693,18135,Indiana,Randolph,532,665,96,133,37,0.278195488721805,50th-75th percentile
694,18011,Indiana,Boone,967,1070,118,103,-15,-0.145631067961165,Bottom 25th percentile
695,18015,Indiana,Carroll,336,357,41,21,-20,-0.952380952380952,Bottom 25th percentile
696,18023,Indiana,Clinton,629,751,69,122,53,0.434426229508197,Top 25th percentile
697,18017,Indiana,Cass,731,860,120,129,9,0.0697674418604651,25th-50th percentile
698,18181,Indiana,White,520,717,65,197,132,0.67005076142132,Top 25th percentile
699,18019,Indiana,Clark,2224,2516,273,292,19,0.0650684931506849,25th-50th percentile
700,18143,Indiana,Scott,551,679,78,128,50,0.390625,50th-75th percentile
701,18021,Indiana,Clay,527,611,55,84,29,0.345238095238095,50th-75th percentile
702,18153,Indiana,Sullivan,401,464,52,63,11,0.174603174603175,25th-50th percentile
703,18165,Indiana,Vermillion,366,391,46,25,-21,-0.84,Bottom 25th percentile
704,18167,Indiana,Vigo,1995,2320,240,325,85,0.261538461538462,50th-75th percentile
705,18025,Indiana,Crawford,220,262,30,42,12,0.285714285714286,50th-75th percentile
706,18061,Indiana,Harrison,738,855,93,117,24,0.205128205128205,25th-50th percentile
707,18123,Indiana,Perry,397,417,52,20,-32,-1.6,Bottom 25th percentile
708,18027,Indiana,Daviess,602,652,99,50,-49,-0.98,Bottom 25th percentile
709,18083,Indiana,Knox,768,911,102,143,41,0.286713286713287,50th-75th percentile
710,18101,Indiana,Martin,190,208,15,18,3,0.166666666666667,25th-50th percentile
711,18029,Indiana,Dearborn,868,995,126,127,1,0.0078740157480315,25th-50th percentile
712,18115,Indiana,Ohio,116,141,18,25,7,0.28,50th-75th percentile
713,18137,Indiana,Ripley,528,673,95,145,50,0.344827586206897,50th-75th percentile
714,18155,Indiana,Switzerland,185,178,10,-7,-17,2.42857142857143,Top 25th percentile
715,18031,Indiana,Decatur,520,606,88,86,-2,-0.0232558139534884,25th-50th percentile
716,18145,Indiana,Shelby,836,945,107,109,2,0.018348623853211,25th-50th percentile
717,18033,Indiana,DeKalb,760,860,99,100,1,0.01,25th-50th percentile
718,18151,Indiana,Steuben,579,653,73,74,1,0.0135135135135135,25th-50th percentile
719,18035,Indiana,Delaware,2276,2551,227,275,48,0.174545454545455,25th-50th percentile
720,18037,Indiana,Dubois,729,879,102,150,48,0.32,50th-75th percentile
721,18125,Indiana,Pike,294,321,40,27,-13,-0.481481481481482,Bottom 25th percentile
722,18147,Indiana,Spencer,366,452,44,86,42,0.488372093023256,Top 25th percentile
723,18039,Indiana,Elkhart,3069,3584,470,515,45,0.087378640776699,25th-50th percentile
724,18041,Indiana,Fayette,548,642,86,94,8,0.0851063829787234,25th-50th percentile
725,18047,Indiana,Franklin,386,449,52,63,11,0.174603174603175,25th-50th percentile
726,18161,Indiana,Union,127,164,17,37,20,0.540540540540541,Top 25th percentile
727,18043,Indiana,Floyd,1454,1643,157,189,32,0.169312169312169,25th-50th percentile
728,18045,Indiana,Fountain,389,442,47,53,6,0.113207547169811,25th-50th percentile
729,18107,Indiana,Montgomery,736,829,106,93,-13,-0.139784946236559,Bottom 25th percentile
730,18171,Indiana,Warren,149,194,12,45,33,0.733333333333333,Top 25th percentile
731,18049,Indiana,Fulton,434,486,57,52,-5,-0.0961538461538462,Bottom 25th percentile
732,18103,Indiana,Miami,686,810,85,124,39,0.314516129032258,50th-75th percentile
733,18169,Indiana,Wabash,790,897,91,107,16,0.149532710280374,25th-50th percentile
734,18051,Indiana,Gibson,636,743,110,107,-3,-0.0280373831775701,25th-50th percentile
735,18129,Indiana,Posey,442,463,41,21,-20,-0.952380952380952,Bottom 25th percentile
736,18053,Indiana,Grant,1460,1795,206,335,129,0.385074626865672,50th-75th percentile
737,18055,Indiana,Greene,701,778,83,77,-6,-0.0779220779220779,Bottom 25th percentile
738,18119,Indiana,Owen,419,332,36,-87,-123,1.41379310344828,Top 25th percentile
739,18121,Indiana,Parke,319,319,38,0,-38,-inf,Bottom 25th percentile
740,18133,Indiana,Putnam,662,740,78,78,0,0.0,25th-50th percentile
741,18057,Indiana,Hamilton,3350,3958,403,608,205,0.337171052631579,50th-75th percentile
742,18059,Indiana,Hancock,1226,1400,161,174,13,0.0747126436781609,25th-50th percentile
743,18063,Indiana,Hendricks,2240,2481,294,241,-53,-0.219917012448133,Bottom 25th percentile
744,18065,Indiana,Henry,1046,1216,147,170,23,0.135294117647059,25th-50th percentile
745,18139,Indiana,Rush,347,381,35,34,-1,-0.0294117647058824,25th-50th percentile
746,18067,Indiana,Howard,1869,2196,265,327,62,0.18960244648318,25th-50th percentile
747,18159,Indiana,Tipton,341,387,58,46,-12,-0.260869565217391,Bottom 25th percentile
748,18069,Indiana,Huntington,738,866,85,128,43,0.3359375,50th-75th percentile
749,18183,Indiana,Whitley,579,633,53,54,1,0.0185185185185185,25th-50th percentile
750,18071,Indiana,Jackson,833,949,86,116,30,0.258620689655172,50th-75th percentile
751,18175,Indiana,Washington,547,617,55,70,15,0.214285714285714,25th-50th percentile
752,18077,Indiana,Jefferson,658,739,97,81,-16,-0.197530864197531,Bottom 25th percentile
753,18079,Indiana,Jennings,522,599,52,77,25,0.324675324675325,50th-75th percentile
754,18081,Indiana,Johnson,2484,2916,383,432,49,0.113425925925926,25th-50th percentile
755,18085,Indiana,Kosciusko,1276,1473,129,197,68,0.345177664974619,50th-75th percentile
756,18087,Indiana,LaGrange,523,564,95,41,-54,-1.31707317073171,Bottom 25th percentile
757,18113,Indiana,Noble,821,902,79,81,2,0.0246913580246914,25th-50th percentile
758,18089,Indiana,Lake,8738,10138,1053,1400,347,0.247857142857143,50th-75th percentile
759,18091,Indiana,LaPorte,2126,2343,194,217,23,0.105990783410138,25th-50th percentile
760,18093,Indiana,Lawrence,968,1172,162,204,42,0.205882352941176,25th-50th percentile
761,18117,Indiana,Orange,410,510,64,100,36,0.36,50th-75th percentile
762,18095,Indiana,Madison,2623,3153,393,530,137,0.258490566037736,50th-75th percentile
763,18097,Indiana,Marion,13958,16395,2038,2437,399,0.163725892490767,25th-50th percentile
764,18099,Indiana,Marshall,804,968,117,164,47,0.286585365853659,50th-75th percentile
765,18131,Indiana,Pulaski,307,327,49,20,-29,-1.45,Bottom 25th percentile
766,18149,Indiana,Starke,463,602,77,139,62,0.446043165467626,Top 25th percentile
767,18105,Indiana,Monroe,1738,2009,196,271,75,0.276752767527675,50th-75th percentile
768,18109,Indiana,Morgan,1246,1469,166,223,57,0.255605381165919,50th-75th percentile
769,18127,Indiana,Porter,2704,3154,303,450,147,0.326666666666667,50th-75th percentile
770,18141,Indiana,St. Joseph,4818,5412,530,594,64,0.107744107744108,25th-50th percentile
771,18157,Indiana,Tippecanoe,2198,2397,207,199,-8,-0.0402010050251256,25th-50th percentile
772,18163,Indiana,Vanderburgh,3487,4010,437,523,86,0.164435946462715,25th-50th percentile
773,18173,Indiana,Warrick,1092,1326,145,234,89,0.38034188034188,50th-75th percentile
774,18177,Indiana,Wayne,1507,1780,219,273,54,0.197802197802198,25th-50th percentile
775,19005,Iowa,Allamakee,327,353,44,26,-18,-0.692307692307692,Bottom 25th percentile
776,19043,Iowa,Clayton,355,418,45,63,18,0.285714285714286,50th-75th percentile
777,19191,Iowa,Winneshiek,348,351,35,3,-32,-10.6666666666667,Bottom 25th percentile
778,19001,Iowa,Adair,179,209,18,30,12,0.4,50th-75th percentile
779,19009,Iowa,Audubon,143,131,8,-12,-20,1.66666666666667,Top 25th percentile
780,19029,Iowa,Cass,353,359,58,6,-52,-8.66666666666667,Bottom 25th percentile
781,19077,Iowa,Guthrie,220,243,30,23,-7,-0.304347826086957,Bottom 25th percentile
782,19165,Iowa,Shelby,266,292,33,26,-7,-0.269230769230769,Bottom 25th percentile
783,19011,Iowa,Benton,430,453,49,23,-26,-1.1304347826087,Bottom 25th percentile
784,19095,Iowa,Iowa (county),353,403,29,50,21,0.42,Top 25th percentile
785,19107,Iowa,Keokuk,208,260,38,52,14,0.269230769230769,50th-75th percentile
786,19183,Iowa,Washington,438,479,56,41,-15,-0.365853658536585,Bottom 25th percentile
787,19013,Iowa,Black Hawk,2184,2532,339,348,9,0.0258620689655172,25th-50th percentile
788,19015,Iowa,Boone,515,577,35,62,27,0.435483870967742,Top 25th percentile
789,19027,Iowa,Carroll,418,485,43,67,24,0.358208955223881,50th-75th percentile
790,19073,Iowa,Greene,207,205,5,-2,-7,3.5,Top 25th percentile
791,19017,Iowa,Bremer,434,506,61,72,11,0.152777777777778,25th-50th percentile
792,19023,Iowa,Butler,348,329,35,-19,-54,2.84210526315789,Top 25th percentile
793,19075,Iowa,Grundy,290,280,29,-10,-39,3.9,Top 25th percentile
794,19019,Iowa,Buchanan,374,386,34,12,-22,-1.83333333333333,Bottom 25th percentile
795,19055,Iowa,Delaware,312,337,46,25,-21,-0.84,Bottom 25th percentile
796,19065,Iowa,Fayette,427,477,48,50,2,0.04,25th-50th percentile
797,19031,Iowa,Cedar,332,366,23,34,11,0.323529411764706,50th-75th percentile
798,19045,Iowa,Clinton,973,1027,101,54,-47,-0.87037037037037,Bottom 25th percentile
799,19097,Iowa,Jackson,393,453,43,60,17,0.283333333333333,50th-75th percentile
800,19105,Iowa,Jones,359,416,54,57,3,0.0526315789473684,25th-50th percentile
801,19033,Iowa,Cerro Gordo,891,1037,103,146,43,0.294520547945206,50th-75th percentile
802,19081,Iowa,Hancock,207,236,32,29,-3,-0.103448275862069,Bottom 25th percentile
803,19189,Iowa,Winnebago,223,257,30,34,4,0.117647058823529,25th-50th percentile
804,19049,Iowa,Dallas,967,1061,98,94,-4,-0.0425531914893617,25th-50th percentile
805,19051,Iowa,Davis,165,156,22,-9,-31,3.44444444444444,Top 25th percentile
806,19101,Iowa,Jefferson,323,342,36,19,-17,-0.894736842105263,Bottom 25th percentile
807,19177,Iowa,Van Buren,166,165,17,-1,-18,18.0,Top 25th percentile
808,19179,Iowa,Wapello,739,844,136,105,-31,-0.295238095238095,Bottom 25th percentile
809,19057,Iowa,Des Moines,805,895,92,90,-2,-0.0222222222222222,25th-50th percentile
810,19087,Iowa,Henry,385,466,53,81,28,0.345679012345679,50th-75th percentile
811,19111,Iowa,Lee,750,884,98,134,36,0.26865671641791,50th-75th percentile
812,19061,Iowa,Dubuque,1625,1768,219,143,-76,-0.531468531468532,Bottom 25th percentile
813,19069,Iowa,Franklin,216,274,26,58,32,0.551724137931035,Top 25th percentile
814,19079,Iowa,Hamilton,332,344,52,12,-40,-3.33333333333333,Bottom 25th percentile
815,19083,Iowa,Hardin,391,456,41,65,24,0.369230769230769,50th-75th percentile
816,19197,Iowa,Wright,335,326,41,-9,-50,5.55555555555556,Top 25th percentile
817,19071,Iowa,Fremont,163,149,13,-14,-27,1.92857142857143,Top 25th percentile
818,19085,Iowa,Harrison,350,388,73,38,-35,-0.921052631578947,Bottom 25th percentile
819,19129,Iowa,Mills,237,267,22,30,8,0.266666666666667,50th-75th percentile
820,19155,Iowa,Pottawattamie,1673,1963,184,290,106,0.36551724137931,50th-75th percentile
821,19099,Iowa,Jasper,694,795,80,101,21,0.207920792079208,25th-50th percentile
822,19157,Iowa,Poweshiek,390,416,41,26,-15,-0.576923076923077,Bottom 25th percentile
823,19103,Iowa,Johnson,1335,1444,96,109,13,0.119266055045872,25th-50th percentile
824,19113,Iowa,Linn,3169,3604,381,435,54,0.124137931034483,25th-50th percentile
825,19115,Iowa,Louisa,193,212,46,19,-27,-1.42105263157895,Bottom 25th percentile
826,19139,Iowa,Muscatine,736,861,117,125,8,0.064,25th-50th percentile
827,19007,Iowa,Appanoose,320,342,43,22,-21,-0.954545454545455,Bottom 25th percentile
828,19039,Iowa,Clarke,194,226,23,32,9,0.28125,50th-75th percentile
829,19053,Iowa,Decatur,147,164,9,17,8,0.470588235294118,Top 25th percentile
830,19117,Iowa,Lucas,195,213,15,18,3,0.166666666666667,25th-50th percentile
831,19135,Iowa,Monroe,178,205,29,27,-2,-0.0740740740740741,Bottom 25th percentile
832,19185,Iowa,Wayne,151,159,24,8,-16,-2.0,Bottom 25th percentile
833,19119,Iowa,Lyon,196,192,38,-4,-42,10.5,Top 25th percentile
834,19141,Iowa,O'Brien,359,397,60,38,-22,-0.578947368421053,Bottom 25th percentile
835,19143,Iowa,Osceola,121,157,14,36,22,0.611111111111111,Top 25th percentile
836,19167,Iowa,Sioux,435,490,73,55,-18,-0.327272727272727,Bottom 25th percentile
837,19121,Iowa,Madison,300,275,22,-25,-47,1.88,Top 25th percentile
838,19181,Iowa,Warren,779,869,93,90,-3,-0.0333333333333333,25th-50th percentile
839,19123,Iowa,Mahaska,430,478,55,48,-7,-0.145833333333333,Bottom 25th percentile
840,19125,Iowa,Marion,616,650,81,34,-47,-1.38235294117647,Bottom 25th percentile
841,19127,Iowa,Marshall,843,941,82,98,16,0.163265306122449,25th-50th percentile
842,19171,Iowa,Tama,367,416,73,49,-24,-0.489795918367347,Bottom 25th percentile
843,19037,Iowa,Chickasaw,240,277,15,37,22,0.594594594594595,Top 25th percentile
844,19067,Iowa,Floyd,319,373,38,54,16,0.296296296296296,50th-75th percentile
845,19089,Iowa,Howard,207,215,22,8,-14,-1.75,Bottom 25th percentile
846,19131,Iowa,Mitchell,249,267,39,18,-21,-1.16666666666667,Bottom 25th percentile
847,19195,Iowa,Worth,144,148,11,4,-7,-1.75,Bottom 25th percentile
848,19041,Iowa,Clay,345,351,31,6,-25,-4.16666666666667,Bottom 25th percentile
849,19059,Iowa,Dickinson,375,402,50,27,-23,-0.851851851851852,Bottom 25th percentile
850,19063,Iowa,Emmet,217,234,43,17,-26,-1.52941176470588,Bottom 25th percentile
851,19109,Iowa,Kossuth,318,369,67,51,-16,-0.313725490196078,Bottom 25th percentile
852,19147,Iowa,Palo Alto,225,238,31,13,-18,-1.38461538461538,Bottom 25th percentile
853,19021,Iowa,Buena Vista,344,341,43,-3,-46,15.3333333333333,Top 25th percentile
854,19025,Iowa,Calhoun,238,231,7,-7,-14,2.0,Top 25th percentile
855,19091,Iowa,Humboldt,204,219,25,15,-10,-0.666666666666667,Bottom 25th percentile
856,19151,Iowa,Pocahontas,171,185,18,14,-4,-0.285714285714286,Bottom 25th percentile
857,19161,Iowa,Sac,238,267,20,29,9,0.310344827586207,50th-75th percentile
858,19187,Iowa,Webster,748,904,102,156,54,0.346153846153846,50th-75th percentile
859,19153,Iowa,Polk,6402,7309,700,907,207,0.228224917309813,25th-50th percentile
860,19163,Iowa,Scott,2700,3162,270,462,192,0.415584415584416,Top 25th percentile
861,19169,Iowa,Story,997,966,50,-31,-81,2.61290322580645,Top 25th percentile
862,19003,Iowa,Adams,76,89,11,13,2,0.153846153846154,25th-50th percentile
863,19137,Iowa,Montgomery,287,303,43,16,-27,-1.6875,Bottom 25th percentile
864,19145,Iowa,Page,366,359,27,-7,-34,4.85714285714286,Top 25th percentile
865,19159,Iowa,Ringgold,137,174,22,37,15,0.405405405405405,50th-75th percentile
866,19173,Iowa,Taylor,136,166,9,30,21,0.7,Top 25th percentile
867,19175,Iowa,Union,275,290,27,15,-12,-0.8,Bottom 25th percentile
868,19035,Iowa,Cherokee,313,298,35,-15,-50,3.33333333333333,Top 25th percentile
869,19047,Iowa,Crawford,309,316,41,7,-34,-4.85714285714286,Bottom 25th percentile
870,19093,Iowa,Ida,180,200,37,20,-17,-0.85,Bottom 25th percentile
871,19133,Iowa,Monona,284,298,37,14,-23,-1.64285714285714,Bottom 25th percentile
872,19149,Iowa,Plymouth,427,480,80,53,-27,-0.509433962264151,Bottom 25th percentile
873,19193,Iowa,Woodbury,1719,1962,234,243,9,0.037037037037037,25th-50th percentile
874,20001,Kansas,Allen,301,297,18,-4,-22,5.5,Top 25th percentile
875,20003,Kansas,Anderson,181,174,24,-7,-31,4.42857142857143,Top 25th percentile
876,20059,Kansas,Franklin,472,547,50,75,25,0.333333333333333,50th-75th percentile
877,20139,Kansas,Osage,341,444,43,103,60,0.58252427184466,Top 25th percentile
878,20011,Kansas,Bourbon,342,362,45,20,-25,-1.25,Bottom 25th percentile
879,20107,Kansas,Linn,192,262,24,70,46,0.657142857142857,Top 25th percentile
880,20121,Kansas,Miami,508,634,68,126,58,0.46031746031746,Top 25th percentile
881,20005,Kansas,Atchison,334,326,18,-8,-26,3.25,Top 25th percentile
882,20013,Kansas,Brown,229,273,37,44,7,0.159090909090909,25th-50th percentile
883,20043,Kansas,Doniphan,162,185,24,23,-1,-0.0434782608695652,25th-50th percentile
884,20085,Kansas,Jackson,247,249,22,2,-20,-10.0,Bottom 25th percentile
885,20087,Kansas,Jefferson,350,338,43,-12,-55,4.58333333333333,Top 25th percentile
886,20117,Kansas,Marshall,234,232,32,-2,-34,17.0,Top 25th percentile
887,20131,Kansas,Nemaha,235,266,49,31,-18,-0.580645161290323,Bottom 25th percentile
888,20015,Kansas,Butler,1154,1313,119,159,40,0.251572327044025,50th-75th percentile
889,20079,Kansas,Harvey,713,839,85,126,41,0.325396825396825,50th-75th percentile
890,20009,Kansas,Barton,500,610,60,110,50,0.454545454545455,Top 25th percentile
891,20051,Kansas,Ellis,421,453,72,32,-40,-1.25,Bottom 25th percentile
892,20053,Kansas,Ellsworth,144,167,25,23,-2,-0.0869565217391304,Bottom 25th percentile
893,20113,Kansas,McPherson,627,726,86,99,13,0.131313131313131,25th-50th percentile
894,20159,Kansas,Rice,204,227,11,23,12,0.521739130434783,Top 25th percentile
895,20167,Kansas,Russell,157,206,30,49,19,0.387755102040816,50th-75th percentile
896,20017,Kansas,Chase,58,54,6,-4,-10,2.5,Top 25th percentile
897,20031,Kansas,Coffey,171,178,15,7,-8,-1.14285714285714,Bottom 25th percentile
898,20111,Kansas,Lyon,496,589,92,93,1,0.010752688172043,25th-50th percentile
899,20115,Kansas,Marion,305,319,31,14,-17,-1.21428571428571,Bottom 25th percentile
900,20021,Kansas,Cherokee,484,551,65,67,2,0.0298507462686567,25th-50th percentile
901,20037,Kansas,Crawford,793,966,108,173,65,0.375722543352601,50th-75th percentile
902,20027,Kansas,Clay,174,190,23,16,-7,-0.4375,Bottom 25th percentile
903,20029,Kansas,Cloud,241,262,26,21,-5,-0.238095238095238,Bottom 25th percentile
904,20089,Kansas,Jewell,65,85,6,20,14,0.7,Top 25th percentile
905,20105,Kansas,Lincoln,64,71,9,7,-2,-0.285714285714286,Bottom 25th percentile
906,20123,Kansas,Mitchell,145,167,15,22,7,0.318181818181818,50th-75th percentile
907,20141,Kansas,Osborne,100,98,11,-2,-13,6.5,Top 25th percentile
908,20143,Kansas,Ottawa,126,129,18,3,-15,-5.0,Bottom 25th percentile
909,20157,Kansas,Republic,141,153,17,12,-5,-0.416666666666667,Bottom 25th percentile
910,20183,Kansas,Smith,98,89,7,-9,-16,1.77777777777778,Top 25th percentile
911,20201,Kansas,Washington,126,133,17,7,-10,-1.42857142857143,Bottom 25th percentile
912,20041,Kansas,Dickinson,409,442,59,33,-26,-0.787878787878788,Bottom 25th percentile
913,20061,Kansas,Geary,350,425,60,75,15,0.2,25th-50th percentile
914,20127,Kansas,Morris,140,142,16,2,-14,-7.0,Bottom 25th percentile
915,20045,Kansas,Douglas,1298,1434,85,136,51,0.375,50th-75th percentile
916,20019,Kansas,Chautauqua,91,95,11,4,-7,-1.75,Bottom 25th percentile
917,20035,Kansas,Cowley,768,844,117,76,-41,-0.539473684210526,Bottom 25th percentile
918,20049,Kansas,Elk,71,81,7,10,3,0.3,50th-75th percentile
919,20073,Kansas,Greenwood,168,180,8,12,4,0.333333333333333,50th-75th percentile
920,20205,Kansas,Wilson,186,229,30,43,13,0.302325581395349,50th-75th percentile
921,20207,Kansas,Woodson,85,102,3,17,14,0.823529411764706,Top 25th percentile
922,20091,Kansas,Johnson,7307,8076,816,769,-47,-0.0611183355006502,Bottom 25th percentile
923,20099,Kansas,Labette,462,505,58,43,-15,-0.348837209302326,Bottom 25th percentile
924,20125,Kansas,Montgomery,748,876,102,128,26,0.203125,25th-50th percentile
925,20133,Kansas,Neosho,363,411,49,48,-1,-0.0208333333333333,25th-50th percentile
926,20103,Kansas,Leavenworth,1125,1303,132,178,46,0.258426966292135,50th-75th percentile
927,20023,Kansas,Cheyenne,63,80,18,17,-1,-0.0588235294117647,Bottom 25th percentile
928,20039,Kansas,Decatur,80,78,6,-2,-8,4.0,Top 25th percentile
929,20063,Kansas,Gove,60,90,24,30,6,0.2,25th-50th percentile
930,20065,Kansas,Graham,62,61,7,-1,-8,8.0,Top 25th percentile
931,20109,Kansas,Logan,58,72,7,14,7,0.5,Top 25th percentile
932,20137,Kansas,Norton,114,126,24,12,-12,-1.0,Bottom 25th percentile
933,20147,Kansas,Phillips,129,137,28,8,-20,-2.5,Bottom 25th percentile
934,20153,Kansas,Rawlins,72,64,7,-8,-15,1.875,Top 25th percentile
935,20163,Kansas,Rooks,113,113,13,0,-13,-inf,Bottom 25th percentile
936,20179,Kansas,Sheridan,51,78,12,27,15,0.555555555555556,Top 25th percentile
937,20181,Kansas,Sherman,119,110,15,-9,-24,2.66666666666667,Top 25th percentile
938,20193,Kansas,Thomas,140,125,17,-15,-32,2.13333333333333,Top 25th percentile
939,20195,Kansas,Trego,75,82,6,7,1,0.142857142857143,25th-50th percentile
940,20199,Kansas,Wallace,29,31,8,2,-6,-3.0,Bottom 25th percentile
941,20025,Kansas,Clark,54,57,10,3,-7,-2.33333333333333,Bottom 25th percentile
942,20033,Kansas,Comanche,55,57,6,2,-4,-2.0,Bottom 25th percentile
943,20047,Kansas,Edwards,89,116,13,27,14,0.518518518518519,Top 25th percentile
944,20057,Kansas,Ford,422,513,87,91,4,0.043956043956044,25th-50th percentile
945,20083,Kansas,Hodgman,45,49,7,4,-3,-0.75,Bottom 25th percentile
946,20097,Kansas,Kiowa,50,53,7,3,-4,-1.33333333333333,Bottom 25th percentile
947,20135,Kansas,Ness,90,101,17,11,-6,-0.545454545454545,Bottom 25th percentile
948,20145,Kansas,Pawnee,151,154,7,3,-4,-1.33333333333333,Bottom 25th percentile
949,20165,Kansas,Rush,105,116,14,11,-3,-0.272727272727273,Bottom 25th percentile
950,20149,Kansas,Pottawatomie,344,364,40,20,-20,-1.0,Bottom 25th percentile
951,20161,Kansas,Riley,659,705,47,46,-1,-0.0217391304347826,25th-50th percentile
952,20197,Kansas,Wabaunsee,107,135,10,28,18,0.642857142857143,Top 25th percentile
953,20155,Kansas,Reno,1243,1417,146,174,28,0.160919540229885,25th-50th percentile
954,20169,Kansas,Saline,976,1184,174,208,34,0.163461538461538,25th-50th percentile
955,20055,Kansas,Finney,388,508,85,120,35,0.291666666666667,50th-75th percentile
956,20071,Kansas,Greeley,42,47,6,5,-1,-0.2,Bottom 25th percentile
957,20075,Kansas,Hamilton,38,45,10,7,-3,-0.428571428571429,Bottom 25th percentile
958,20093,Kansas,Kearny,54,67,9,13,4,0.307692307692308,50th-75th percentile
959,20101,Kansas,Lane,48,60,11,12,1,0.0833333333333333,25th-50th percentile
960,20171,Kansas,Scott,87,112,20,25,5,0.2,25th-50th percentile
961,20203,Kansas,Wichita,39,54,12,15,3,0.2,25th-50th percentile
962,20173,Kansas,Sedgwick,7838,9437,956,1599,643,0.402126328955597,50th-75th percentile
963,20177,Kansas,Shawnee,3295,3745,416,450,34,0.0755555555555556,25th-50th percentile
964,20007,Kansas,Barber,105,125,8,20,12,0.6,Top 25th percentile
965,20077,Kansas,Harper,157,162,21,5,-16,-3.2,Bottom 25th percentile
966,20095,Kansas,Kingman,320,445,60,125,65,0.52,Top 25th percentile
967,20151,Kansas,Pratt,206,236,31,30,-1,-0.0333333333333333,25th-50th percentile
968,20185,Kansas,Stafford,100,119,10,19,9,0.473684210526316,Top 25th percentile
969,20191,Kansas,Sumner,485,553,65,68,3,0.0441176470588235,25th-50th percentile
970,20067,Kansas,Grant,102,111,28,9,-19,-2.11111111111111,Bottom 25th percentile
971,20069,Kansas,Gray,98,107,16,9,-7,-0.777777777777778,Bottom 25th percentile
972,20081,Kansas,Haskell,54,51,8,-3,-11,3.66666666666667,Top 25th percentile
973,20119,Kansas,Meade,84,104,12,20,8,0.4,50th-75th percentile
974,20129,Kansas,Morton,60,74,6,14,8,0.571428571428571,Top 25th percentile
975,20175,Kansas,Seward,226,274,49,48,-1,-0.0208333333333333,25th-50th percentile
976,20187,Kansas,Stanton,35,32,6,-3,-9,3.0,Top 25th percentile
977,20189,Kansas,Stevens,83,93,11,10,-1,-0.1,Bottom 25th percentile
978,20209,Kansas,Wyandotte,2405,2739,349,334,-15,-0.0449101796407186,25th-50th percentile
979,21001,Kentucky,Adair,371,499,82,128,46,0.359375,50th-75th percentile
980,21045,Kentucky,Casey,350,425,60,75,15,0.2,25th-50th percentile
981,21087,Kentucky,Green,263,294,42,31,-11,-0.354838709677419,Bottom 25th percentile
982,21207,Kentucky,Russell,450,538,58,88,30,0.340909090909091,50th-75th percentile
983,21217,Kentucky,Taylor,546,689,83,143,60,0.41958041958042,Top 25th percentile
984,21005,Kentucky,Anderson,415,497,55,82,27,0.329268292682927,50th-75th percentile
985,21073,Kentucky,Franklin,978,1167,111,189,78,0.412698412698413,Top 25th percentile
986,21003,Kentucky,Allen,426,466,67,40,-27,-0.675,Bottom 25th percentile
987,21009,Kentucky,Barren,922,1084,135,162,27,0.166666666666667,25th-50th percentile
988,21099,Kentucky,Hart,398,454,65,56,-9,-0.160714285714286,Bottom 25th percentile
989,21169,Kentucky,Metcalfe,237,291,42,54,12,0.222222222222222,25th-50th percentile
990,21171,Kentucky,Monroe,305,302,67,-3,-70,23.3333333333333,Top 25th percentile
991,21011,Kentucky,Bath,307,327,27,20,-7,-0.35,Bottom 25th percentile
992,21049,Kentucky,Clark,730,771,44,41,-3,-0.0731707317073171,Bottom 25th percentile
993,21173,Kentucky,Montgomery,549,643,67,94,27,0.287234042553192,50th-75th percentile
994,21205,Kentucky,Rowan,403,473,45,70,25,0.357142857142857,50th-75th percentile
995,21013,Kentucky,Bell,683,836,115,153,38,0.248366013071895,50th-75th percentile
996,21095,Kentucky,Harlan,730,955,98,225,127,0.564444444444444,Top 25th percentile
997,21015,Kentucky,Boone,1656,1853,213,197,-16,-0.0812182741116751,Bottom 25th percentile
998,21017,Kentucky,Bourbon,411,484,35,73,38,0.520547945205479,Top 25th percentile
999,21069,Kentucky,Fleming,336,351,43,15,-28,-1.86666666666667,Bottom 25th percentile
1000,21135,Kentucky,Lewis,325,381,62,56,-6,-0.107142857142857,Bottom 25th percentile
1001,21181,Kentucky,Nicholas,171,173,23,2,-21,-10.5,Bottom 25th percentile
1002,21019,Kentucky,Boyd,1129,1285,113,156,43,0.275641025641026,50th-75th percentile
1003,21043,Kentucky,Carter,597,636,62,39,-23,-0.58974358974359,Bottom 25th percentile
1004,21089,Kentucky,Greenup,849,950,91,101,10,0.099009900990099,25th-50th percentile
1005,21021,Kentucky,Boyle,616,725,93,109,16,0.146788990825688,25th-50th percentile
1006,21137,Kentucky,Lincoln,535,686,90,151,61,0.403973509933775,50th-75th percentile
1007,21167,Kentucky,Mercer,512,569,69,57,-12,-0.210526315789474,Bottom 25th percentile
1008,21023,Kentucky,Bracken,159,198,22,39,17,0.435897435897436,Top 25th percentile
1009,21097,Kentucky,Harrison,405,461,48,56,8,0.142857142857143,25th-50th percentile
1010,21161,Kentucky,Mason,418,440,57,22,-35,-1.59090909090909,Bottom 25th percentile
1011,21191,Kentucky,Pendleton,301,344,24,43,19,0.441860465116279,Top 25th percentile
1012,21201,Kentucky,Robertson,55,72,8,17,9,0.529411764705882,Top 25th percentile
1013,21027,Kentucky,Breckinridge,418,531,46,113,67,0.592920353982301,Top 25th percentile
1014,21085,Kentucky,Grayson,562,698,92,136,44,0.323529411764706,50th-75th percentile
1015,21091,Kentucky,Hancock,152,208,12,56,44,0.785714285714286,Top 25th percentile
1016,21163,Kentucky,Meade,456,539,55,83,28,0.337349397590361,50th-75th percentile
1017,21029,Kentucky,Bullitt,1134,1351,144,217,73,0.336405529953917,50th-75th percentile
1018,21215,Kentucky,Spencer,306,340,33,34,1,0.0294117647058824,25th-50th percentile
1019,21031,Kentucky,Butler,309,346,44,37,-7,-0.189189189189189,Bottom 25th percentile
1020,21149,Kentucky,McLean,209,261,33,52,19,0.365384615384615,50th-75th percentile
1021,21177,Kentucky,Muhlenberg,676,761,99,85,-14,-0.164705882352941,Bottom 25th percentile
1022,21183,Kentucky,Ohio,511,596,72,85,13,0.152941176470588,25th-50th percentile
1023,21035,Kentucky,Calloway,717,841,72,124,52,0.419354838709677,Top 25th percentile
1024,21157,Kentucky,Marshall,777,837,77,60,-17,-0.283333333333333,Bottom 25th percentile
1025,21037,Kentucky,Campbell,1491,1626,117,135,18,0.133333333333333,25th-50th percentile
1026,21047,Kentucky,Christian,1076,1349,156,273,117,0.428571428571429,Top 25th percentile
1027,21051,Kentucky,Clay,480,555,61,75,14,0.186666666666667,25th-50th percentile
1028,21109,Kentucky,Jackson,333,370,54,37,-17,-0.45945945945946,Bottom 25th percentile
1029,21131,Kentucky,Leslie,262,299,29,37,8,0.216216216216216,25th-50th percentile
1030,21189,Kentucky,Owsley,121,163,19,42,23,0.547619047619048,Top 25th percentile
1031,21053,Kentucky,Clinton,231,287,38,56,18,0.321428571428571,50th-75th percentile
1032,21057,Kentucky,Cumberland,178,194,10,16,6,0.375,50th-75th percentile
1033,21147,Kentucky,McCreary,395,453,63,58,-5,-0.0862068965517242,Bottom 25th percentile
1034,21231,Kentucky,Wayne,417,528,60,111,51,0.45945945945946,Top 25th percentile
1035,21059,Kentucky,Daviess,1944,2137,249,193,-56,-0.290155440414508,Bottom 25th percentile
1036,21061,Kentucky,Edmonson,289,302,44,13,-31,-2.38461538461538,Bottom 25th percentile
1037,21227,Kentucky,Warren,1885,2204,231,319,88,0.275862068965517,50th-75th percentile
1038,21063,Kentucky,Elliott,135,165,17,30,13,0.433333333333333,Top 25th percentile
1039,21115,Kentucky,Johnson,552,669,78,117,39,0.333333333333333,50th-75th percentile
1040,21127,Kentucky,Lawrence,369,393,41,24,-17,-0.708333333333333,Bottom 25th percentile
1041,21153,Kentucky,Magoffin,305,314,32,9,-23,-2.55555555555556,Bottom 25th percentile
1042,21065,Kentucky,Estill,350,410,37,60,23,0.383333333333333,50th-75th percentile
1043,21151,Kentucky,Madison,1455,1670,179,215,36,0.167441860465116,25th-50th percentile
1044,21203,Kentucky,Rockcastle,363,435,41,72,31,0.430555555555556,Top 25th percentile
1045,21067,Kentucky,Fayette,4178,4674,340,496,156,0.314516129032258,50th-75th percentile
1046,21071,Kentucky,Floyd,920,1144,142,224,82,0.366071428571429,50th-75th percentile
1047,21159,Kentucky,Martin,271,279,30,8,-22,-2.75,Bottom 25th percentile
1048,21079,Kentucky,Garrard,332,394,49,62,13,0.209677419354839,25th-50th percentile
1049,21113,Kentucky,Jessamine,836,959,88,123,35,0.284552845528455,50th-75th percentile
1050,21093,Kentucky,Hardin,1682,2165,266,483,217,0.449275362318841,Top 25th percentile
1051,21123,Kentucky,Larue,328,343,39,15,-24,-1.6,Bottom 25th percentile
1052,21101,Kentucky,Henderson,894,1087,123,193,70,0.362694300518135,50th-75th percentile
1053,21225,Kentucky,Union,309,348,40,39,-1,-0.0256410256410256,25th-50th percentile
1054,21103,Kentucky,Henry,341,342,28,1,-27,-27.0,Bottom 25th percentile
1055,21211,Kentucky,Shelby,688,815,97,127,30,0.236220472440945,25th-50th percentile
1056,21107,Kentucky,Hopkins,1025,1262,188,237,49,0.206751054852321,25th-50th percentile
1057,21233,Kentucky,Webster,308,343,48,35,-13,-0.371428571428571,Bottom 25th percentile
1058,21111,Kentucky,Jefferson,13634,15654,1518,2020,502,0.248514851485149,50th-75th percentile
1059,21117,Kentucky,Kenton,2615,2779,258,164,-94,-0.573170731707317,Bottom 25th percentile
1060,21119,Kentucky,Knott,357,393,40,36,-4,-0.111111111111111,Bottom 25th percentile
1061,21133,Kentucky,Letcher,582,682,79,100,21,0.21,25th-50th percentile
1062,21193,Kentucky,Perry,762,926,109,164,55,0.335365853658537,50th-75th percentile
1063,21121,Kentucky,Knox,710,867,107,157,50,0.318471337579618,50th-75th percentile
1064,21235,Kentucky,Whitley,866,990,118,124,6,0.0483870967741936,25th-50th percentile
1065,21125,Kentucky,Laurel,1178,1503,150,325,175,0.538461538461538,Top 25th percentile
1066,21141,Kentucky,Logan,587,634,73,47,-26,-0.553191489361702,Bottom 25th percentile
1067,21213,Kentucky,Simpson,394,447,69,53,-16,-0.30188679245283,Bottom 25th percentile
1068,21219,Kentucky,Todd,243,264,27,21,-6,-0.285714285714286,Bottom 25th percentile
1069,21033,Kentucky,Caldwell,314,334,40,20,-20,-1.0,Bottom 25th percentile
1070,21055,Kentucky,Crittenden,224,244,32,20,-12,-0.6,Bottom 25th percentile
1071,21139,Kentucky,Livingston,265,309,44,44,0,0.0,25th-50th percentile
1072,21143,Kentucky,Lyon,208,232,24,24,0,0.0,25th-50th percentile
1073,21221,Kentucky,Trigg,330,386,24,56,32,0.571428571428571,Top 25th percentile
1074,21145,Kentucky,McCracken,1398,1652,174,254,80,0.31496062992126,50th-75th percentile
1075,21155,Kentucky,Marion,378,407,46,29,-17,-0.586206896551724,Bottom 25th percentile
1076,21179,Kentucky,Nelson,778,943,107,165,58,0.351515151515152,50th-75th percentile
1077,21229,Kentucky,Washington,284,272,42,-12,-54,4.5,Top 25th percentile
1078,21185,Kentucky,Oldham,765,815,75,50,-25,-0.5,Bottom 25th percentile
1079,21041,Kentucky,Carroll,240,237,30,-3,-33,11.0,Top 25th percentile
1080,21077,Kentucky,Gallatin,165,203,32,38,6,0.157894736842105,25th-50th percentile
1081,21081,Kentucky,Grant,430,494,40,64,24,0.375,50th-75th percentile
1082,21187,Kentucky,Owen,197,273,28,76,48,0.631578947368421,Top 25th percentile
1083,21223,Kentucky,Trimble,174,206,28,32,4,0.125,25th-50th percentile
1084,21195,Kentucky,Pike,1359,1746,184,387,203,0.524547803617571,Top 25th percentile
1085,21199,Kentucky,Pulaski,1467,1689,201,222,21,0.0945945945945946,25th-50th percentile
1086,21209,Kentucky,Scott,771,822,59,51,-8,-0.156862745098039,Bottom 25th percentile
1087,21239,Kentucky,Woodford,444,478,30,34,4,0.117647058823529,25th-50th percentile
1088,21007,Kentucky,Ballard,185,209,28,24,-4,-0.166666666666667,Bottom 25th percentile
1089,21039,Kentucky,Carlisle,128,159,7,31,24,0.774193548387097,Top 25th percentile
1090,21075,Kentucky,Fulton,168,207,32,39,7,0.17948717948718,25th-50th percentile
1091,21083,Kentucky,Graves,811,973,109,162,53,0.327160493827161,50th-75th percentile
1092,21105,Kentucky,Hickman,114,147,10,33,23,0.696969696969697,Top 25th percentile
1093,21025,Kentucky,Breathitt,333,413,46,80,34,0.425,Top 25th percentile
1094,21129,Kentucky,Lee,186,247,32,61,29,0.475409836065574,Top 25th percentile
1095,21165,Kentucky,Menifee,154,185,24,31,7,0.225806451612903,25th-50th percentile
1096,21175,Kentucky,Morgan,266,287,26,21,-5,-0.238095238095238,Bottom 25th percentile
1097,21197,Kentucky,Powell,324,336,19,12,-7,-0.583333333333333,Bottom 25th percentile
1098,21237,Kentucky,Wolfe,186,236,14,50,36,0.72,Top 25th percentile
1099,22001,Louisiana,Acadia,1165,1511,213,346,133,0.384393063583815,50th-75th percentile
1100,22053,Louisiana,Jefferson Davis,683,822,119,139,20,0.143884892086331,25th-50th percentile
1101,22003,Louisiana,Allen,461,594,90,133,43,0.323308270676692,50th-75th percentile
1102,22039,Louisiana,Evangeline,652,847,133,195,62,0.317948717948718,50th-75th percentile
1103,22005,Louisiana,Ascension,1316,1644,224,328,104,0.317073170731707,50th-75th percentile
1104,22007,Louisiana,Assumption,384,493,54,109,55,0.504587155963303,Top 25th percentile
1105,22093,Louisiana,St. James,352,426,59,74,15,0.202702702702703,25th-50th percentile
1106,22095,Louisiana,St. John the Baptist,702,847,133,145,12,0.0827586206896552,25th-50th percentile
1107,22009,Louisiana,Avoyelles,843,1046,145,203,58,0.285714285714286,50th-75th percentile
1108,22037,Louisiana,East Feliciana,434,519,103,85,-18,-0.211764705882353,Bottom 25th percentile
1109,22077,Louisiana,Pointe Coupee,444,552,71,108,37,0.342592592592593,50th-75th percentile
1110,22125,Louisiana,West Feliciana,240,278,39,38,-1,-0.0263157894736842,25th-50th percentile
1111,22011,Louisiana,Beauregard,691,827,123,136,13,0.0955882352941176,25th-50th percentile
1112,22115,Louisiana,Vernon,703,907,134,204,70,0.343137254901961,50th-75th percentile
1113,22013,Louisiana,Bienville,349,456,72,107,35,0.327102803738318,50th-75th percentile
1114,22069,Louisiana,Natchitoches,702,888,120,186,66,0.354838709677419,50th-75th percentile
1115,22081,Louisiana,Red River,185,254,46,69,23,0.333333333333333,50th-75th percentile
1116,22015,Louisiana,Bossier,1914,2307,306,393,87,0.221374045801527,25th-50th percentile
1117,22017,Louisiana,Caddo,4665,6070,849,1405,556,0.395729537366548,50th-75th percentile
1118,22019,Louisiana,Calcasieu,3583,4317,582,734,152,0.20708446866485,25th-50th percentile
1119,22023,Louisiana,Cameron,89,103,6,14,8,0.571428571428571,Top 25th percentile
1120,22113,Louisiana,Vermilion,1020,1291,145,271,126,0.464944649446495,Top 25th percentile
1121,22021,Louisiana,Caldwell,218,267,37,49,12,0.244897959183673,50th-75th percentile
1122,22025,Louisiana,Catahoula,214,268,46,54,8,0.148148148148148,25th-50th percentile
1123,22029,Louisiana,Concordia,411,526,72,115,43,0.373913043478261,50th-75th percentile
1124,22059,Louisiana,La Salle,304,361,44,57,13,0.228070175438597,25th-50th percentile
1125,22107,Louisiana,Tensas,96,143,12,47,35,0.74468085106383,Top 25th percentile
1126,22027,Louisiana,Claiborne,332,376,63,44,-19,-0.431818181818182,Bottom 25th percentile
1127,22119,Louisiana,Webster,883,1198,143,315,172,0.546031746031746,Top 25th percentile
1128,22031,Louisiana,De Soto,544,627,106,83,-23,-0.27710843373494,Bottom 25th percentile
1129,22085,Louisiana,Sabine,483,663,97,180,83,0.461111111111111,Top 25th percentile
1130,22033,Louisiana,East Baton Rouge,6503,8197,1043,1694,651,0.384297520661157,50th-75th percentile
1131,22043,Louisiana,Grant,384,482,68,98,30,0.306122448979592,50th-75th percentile
1132,22049,Louisiana,Jackson,344,403,32,59,27,0.457627118644068,Top 25th percentile
1133,22127,Louisiana,Winn,312,379,49,67,18,0.26865671641791,50th-75th percentile
1134,22045,Louisiana,Iberia,1253,1588,173,335,162,0.483582089552239,Top 25th percentile
1135,22047,Louisiana,Iberville,565,762,109,197,88,0.446700507614213,Top 25th percentile
1136,22121,Louisiana,West Baton Rouge,366,476,63,110,47,0.427272727272727,Top 25th percentile
1137,22051,Louisiana,Jefferson,7229,8651,989,1422,433,0.30450070323488,50th-75th percentile
1138,22055,Louisiana,Lafayette,3168,3888,308,720,412,0.572222222222222,Top 25th percentile
1139,22057,Louisiana,Lafourche,1556,1964,272,408,136,0.333333333333333,50th-75th percentile
1140,22061,Louisiana,Lincoln,694,876,99,182,83,0.456043956043956,Top 25th percentile
1141,22111,Louisiana,Union,492,647,80,155,75,0.483870967741936,Top 25th percentile
1142,22063,Louisiana,Livingston,1866,2379,357,513,156,0.304093567251462,50th-75th percentile
1143,22035,Louisiana,East Carroll,146,193,32,47,15,0.319148936170213,50th-75th percentile
1144,22041,Louisiana,Franklin,474,568,96,94,-2,-0.0212765957446809,25th-50th percentile
1145,22065,Louisiana,Madison,227,248,48,21,-27,-1.28571428571429,Bottom 25th percentile
1146,22067,Louisiana,Morehouse,621,842,102,221,119,0.538461538461538,Top 25th percentile
1147,22083,Louisiana,Richland,409,522,86,113,27,0.238938053097345,25th-50th percentile
1148,22123,Louisiana,West Carroll,277,292,50,15,-35,-2.33333333333333,Bottom 25th percentile
1149,22071,Louisiana,Orleans,5483,6683,795,1200,405,0.3375,50th-75th percentile
1150,22073,Louisiana,Ouachita,2719,3438,536,719,183,0.25452016689847,50th-75th percentile
1151,22075,Louisiana,Plaquemines,333,401,38,68,30,0.441176470588235,Top 25th percentile
1152,22087,Louisiana,St. Bernard,632,740,88,108,20,0.185185185185185,25th-50th percentile
1153,22079,Louisiana,Rapides,2542,3282,439,740,301,0.406756756756757,50th-75th percentile
1154,22089,Louisiana,St. Charles,753,881,98,128,30,0.234375,25th-50th percentile
1155,22091,Louisiana,St. Helena,206,277,21,71,50,0.704225352112676,Top 25th percentile
1156,22105,Louisiana,Tangipahoa,2217,2710,426,493,67,0.135902636916836,25th-50th percentile
1157,22117,Louisiana,Washington,1013,1253,183,240,57,0.2375,25th-50th percentile
1158,22097,Louisiana,St. Landry,1738,2137,287,399,112,0.280701754385965,50th-75th percentile
1159,22099,Louisiana,St. Martin,854,1121,142,267,125,0.468164794007491,Top 25th percentile
1160,22101,Louisiana,St. Mary,945,1194,189,249,60,0.240963855421687,25th-50th percentile
1161,22103,Louisiana,St. Tammany,3975,4721,555,746,191,0.256032171581769,50th-75th percentile
1162,22109,Louisiana,Terrebonne,1760,2246,275,486,211,0.434156378600823,Top 25th percentile
1163,23001,Maine,Androscoggin,2077,2202,98,125,27,0.216,25th-50th percentile
1164,23003,Maine,Aroostook,1513,1741,83,228,145,0.635964912280702,Top 25th percentile
1165,23005,Maine,Cumberland,4787,5040,236,253,17,0.0671936758893281,25th-50th percentile
1166,23007,Maine,Franklin,608,602,26,-6,-32,5.33333333333333,Top 25th percentile
1167,23017,Maine,Oxford,1188,1297,79,109,30,0.275229357798165,50th-75th percentile
1168,23009,Maine,Hancock,1075,1187,53,112,59,0.526785714285714,Top 25th percentile
1169,23029,Maine,Washington,735,854,19,119,100,0.840336134453782,Top 25th percentile
1170,23011,Maine,Kennebec,2312,2538,97,226,129,0.570796460176991,Top 25th percentile
1171,23013,Maine,Knox,876,836,16,-40,-56,1.4,Top 25th percentile
1172,23027,Maine,Waldo,730,810,37,80,43,0.5375,Top 25th percentile
1173,23015,Maine,Lincoln,711,755,9,44,35,0.795454545454545,Top 25th percentile
1174,23023,Maine,Sagadahoc,635,685,14,50,36,0.72,Top 25th percentile
1175,23019,Maine,Penobscot,2892,3116,186,224,38,0.169642857142857,25th-50th percentile
1176,23021,Maine,Piscataquis,435,442,21,7,-14,-2.0,Bottom 25th percentile
1177,23025,Maine,Somerset,1052,1163,58,111,53,0.477477477477478,Top 25th percentile
1178,23031,Maine,York,3674,3842,194,168,-26,-0.154761904761905,Bottom 25th percentile
1179,24001,Maryland,Allegany,1555,1864,256,309,53,0.171521035598705,25th-50th percentile
1180,24023,Maryland,Garrett,586,707,83,121,38,0.31404958677686,50th-75th percentile
1181,24003,Maryland,Anne Arundel,7641,8311,694,670,-24,-0.0358208955223881,25th-50th percentile
1182,24510,Maryland,Baltimore (city),9971,11730,1191,1759,568,0.32291074474133,50th-75th percentile
1183,24005,Maryland,Baltimore (county),14147,16153,1604,2006,402,0.200398803589232,25th-50th percentile
1184,24009,Maryland,Calvert,1226,1411,108,185,77,0.416216216216216,Top 25th percentile
1185,24011,Maryland,Caroline,586,706,62,120,58,0.483333333333333,Top 25th percentile
1186,24019,Maryland,Dorchester,716,797,76,81,5,0.0617283950617284,25th-50th percentile
1187,24041,Maryland,Talbot,797,941,41,144,103,0.715277777777778,Top 25th percentile
1188,24013,Maryland,Carroll,2796,3171,271,375,104,0.277333333333333,50th-75th percentile
1189,24015,Maryland,Cecil,1701,1974,201,273,72,0.263736263736264,50th-75th percentile
1190,24017,Maryland,Charles,1973,2431,294,458,164,0.358078602620087,50th-75th percentile
1191,24021,Maryland,Frederick,3392,3699,350,307,-43,-0.140065146579805,Bottom 25th percentile
1192,24025,Maryland,Harford,3786,4324,320,538,218,0.405204460966543,50th-75th percentile
1193,24027,Maryland,Howard,3086,3445,251,359,108,0.3008356545961,50th-75th percentile
1194,24029,Maryland,Kent,461,557,55,96,41,0.427083333333333,Top 25th percentile
1195,24035,Maryland,Queen Anne's,790,805,61,15,-46,-3.06666666666667,Bottom 25th percentile
1196,24031,Maryland,Montgomery,11166,12656,1625,1490,-135,-0.0906040268456376,Bottom 25th percentile
1197,24033,Maryland,Prince George's,10696,13597,1885,2901,1016,0.350224060668735,50th-75th percentile
1198,24037,Maryland,St. Mary's,1466,1731,162,265,103,0.388679245283019,50th-75th percentile
1199,24039,Maryland,Somerset,466,559,44,93,49,0.526881720430108,Top 25th percentile
1200,24047,Maryland,Worcester,1136,1284,111,148,37,0.25,50th-75th percentile
1201,24043,Maryland,Washington,2753,3227,341,474,133,0.280590717299578,50th-75th percentile
1202,24045,Maryland,Wicomico,1768,2076,207,308,101,0.327922077922078,50th-75th percentile
1203,25001,Massachusetts,Barnstable,5170,5530,368,360,-8,-0.0222222222222222,25th-50th percentile
1204,25007,Massachusetts,Dukes,298,362,13,64,51,0.796875,Top 25th percentile
1205,25019,Massachusetts,Nantucket,129,141,11,12,1,0.0833333333333333,25th-50th percentile
1206,25003,Massachusetts,Berkshire,2649,2901,226,252,26,0.103174603174603,25th-50th percentile
1207,25005,Massachusetts,Bristol,9448,10287,1260,839,-421,-0.501787842669845,Bottom 25th percentile
1208,25009,Massachusetts,Essex,12195,13482,1705,1287,-418,-0.324786324786325,Bottom 25th percentile
1209,25011,Massachusetts,Franklin,1236,1318,88,82,-6,-0.0731707317073171,Bottom 25th percentile
1210,25013,Massachusetts,Hampden,7910,9186,1127,1276,149,0.116771159874608,25th-50th percentile
1211,25015,Massachusetts,Hampshire,2287,2479,220,192,-28,-0.145833333333333,Bottom 25th percentile
1212,25017,Massachusetts,Middlesex,20451,22484,2788,2033,-755,-0.371372356123955,Bottom 25th percentile
1213,25021,Massachusetts,Norfolk,10410,11062,1227,652,-575,-0.881901840490798,Bottom 25th percentile
1214,25023,Massachusetts,Plymouth,8304,9413,1050,1109,59,0.0532010820559062,25th-50th percentile
1215,25025,Massachusetts,Suffolk,8234,9227,1413,993,-420,-0.422960725075529,Bottom 25th percentile
1216,25027,Massachusetts,Worcester,12732,13449,1664,717,-947,-1.3207810320781,Bottom 25th percentile
1217,26001,Michigan,Alcona,336,349,39,13,-26,-2.0,Bottom 25th percentile
1218,26007,Michigan,Alpena,667,735,57,68,11,0.161764705882353,25th-50th percentile
1219,26141,Michigan,Presque Isle,351,347,31,-4,-35,8.75,Top 25th percentile
1220,26003,Michigan,Alger,200,177,9,-23,-32,1.39130434782609,Top 25th percentile
1221,26041,Michigan,Delta,828,998,91,170,79,0.464705882352941,Top 25th percentile
1222,26153,Michigan,Schoolcraft,198,224,7,26,19,0.730769230769231,Top 25th percentile
1223,26005,Michigan,Allegan,1832,2090,162,258,96,0.372093023255814,50th-75th percentile
1224,26009,Michigan,Antrim,487,540,29,53,24,0.452830188679245,Top 25th percentile
1225,26029,Michigan,Charlevoix,514,539,34,25,-9,-0.36,Bottom 25th percentile
1226,26079,Michigan,Kalkaska,380,416,32,36,4,0.111111111111111,25th-50th percentile
1227,26137,Michigan,Otsego,491,567,51,76,25,0.328947368421053,50th-75th percentile
1228,26011,Michigan,Arenac,357,428,22,71,49,0.690140845070423,Top 25th percentile
1229,26069,Michigan,Iosco,724,814,83,90,7,0.0777777777777778,25th-50th percentile
1230,26129,Michigan,Ogemaw,571,595,58,24,-34,-1.41666666666667,Bottom 25th percentile
1231,26015,Michigan,Barry,1016,1138,82,122,40,0.327868852459016,50th-75th percentile
1232,26017,Michigan,Bay,2234,2625,283,391,108,0.276214833759591,50th-75th percentile
1233,26019,Michigan,Benzie,372,420,34,48,14,0.291666666666667,50th-75th percentile
1234,26101,Michigan,Manistee,567,632,37,65,28,0.430769230769231,Top 25th percentile
1235,26105,Michigan,Mason,601,704,46,103,57,0.553398058252427,Top 25th percentile
1236,26021,Michigan,Berrien,3072,3280,291,208,-83,-0.399038461538462,Bottom 25th percentile
1237,26023,Michigan,Branch,837,918,109,81,-28,-0.345679012345679,Bottom 25th percentile
1238,26059,Michigan,Hillsdale,886,1077,127,191,64,0.335078534031414,50th-75th percentile
1239,26025,Michigan,Calhoun,2682,3123,283,441,158,0.35827664399093,50th-75th percentile
1240,26027,Michigan,Cass,929,1109,102,180,78,0.433333333333333,Top 25th percentile
1241,26031,Michigan,Cheboygan,588,712,78,124,46,0.370967741935484,50th-75th percentile
1242,26047,Michigan,Emmet,662,705,50,43,-7,-0.162790697674419,Bottom 25th percentile
1243,26033,Michigan,Chippewa,643,696,56,53,-3,-0.0566037735849057,Bottom 25th percentile
1244,26095,Michigan,Luce,129,132,10,3,-7,-2.33333333333333,Bottom 25th percentile
1245,26097,Michigan,Mackinac,303,300,11,-3,-14,4.66666666666667,Top 25th percentile
1246,26035,Michigan,Clare,805,895,78,90,12,0.133333333333333,25th-50th percentile
1247,26051,Michigan,Gladwin,655,783,69,128,59,0.4609375,Top 25th percentile
1248,26037,Michigan,Clinton,1100,1254,87,154,67,0.435064935064935,Top 25th percentile
1249,26039,Michigan,Crawford,340,341,12,1,-11,-11.0,Bottom 25th percentile
1250,26119,Michigan,Montmorency,308,338,32,30,-2,-0.0666666666666667,Bottom 25th percentile
1251,26135,Michigan,Oscoda,219,284,35,65,30,0.461538461538462,Top 25th percentile
1252,26143,Michigan,Roscommon,736,792,60,56,-4,-0.0714285714285714,Bottom 25th percentile
1253,26043,Michigan,Dickinson,540,648,87,108,21,0.194444444444444,25th-50th percentile
1254,26071,Michigan,Iron,346,377,42,31,-11,-0.354838709677419,Bottom 25th percentile
1255,26109,Michigan,Menominee,501,530,41,29,-12,-0.413793103448276,Bottom 25th percentile
1256,26045,Michigan,Eaton,1838,2117,193,279,86,0.308243727598566,50th-75th percentile
1257,26049,Michigan,Genesee,7931,9237,902,1306,404,0.309341500765697,50th-75th percentile
1258,26055,Michigan,Grand Traverse,1595,1805,96,210,114,0.542857142857143,Top 25th percentile
1259,26089,Michigan,Leelanau,435,509,24,74,50,0.675675675675676,Top 25th percentile
1260,26057,Michigan,Gratiot,837,915,82,78,-4,-0.0512820512820513,Bottom 25th percentile
1261,26073,Michigan,Isabella,871,1131,100,260,160,0.615384615384615,Top 25th percentile
1262,26063,Michigan,Huron,776,869,90,93,3,0.032258064516129,25th-50th percentile
1263,26151,Michigan,Sanilac,880,1028,136,148,12,0.0810810810810811,25th-50th percentile
1264,26065,Michigan,Ingham,3773,4492,376,719,343,0.477051460361613,Top 25th percentile
1265,26067,Michigan,Ionia,943,1021,75,78,3,0.0384615384615385,25th-50th percentile
1266,26075,Michigan,Jackson,3052,3505,309,453,144,0.317880794701987,50th-75th percentile
1267,26077,Michigan,Kalamazoo,3785,4341,349,556,207,0.372302158273381,50th-75th percentile
1268,26081,Michigan,Kent,8530,9613,760,1083,323,0.298245614035088,50th-75th percentile
1269,26085,Michigan,Lake,316,343,15,27,12,0.444444444444444,Top 25th percentile
1270,26113,Michigan,Missaukee,321,335,29,14,-15,-1.07142857142857,Bottom 25th percentile
1271,26165,Michigan,Wexford,625,726,44,101,57,0.564356435643564,Top 25th percentile
1272,26087,Michigan,Lapeer,1585,1883,228,298,70,0.23489932885906,25th-50th percentile
1273,26091,Michigan,Lenawee,1862,2136,204,274,70,0.255474452554745,50th-75th percentile
1274,26093,Michigan,Livingston,2597,3057,213,460,247,0.536956521739131,Top 25th percentile
1275,26099,Michigan,Macomb,15155,17975,2288,2820,532,0.188652482269504,25th-50th percentile
1276,26103,Michigan,Marquette,1194,1278,70,84,14,0.166666666666667,25th-50th percentile
1277,26107,Michigan,Mecosta,729,828,40,99,59,0.595959595959596,Top 25th percentile
1278,26133,Michigan,Osceola,441,473,46,32,-14,-0.4375,Bottom 25th percentile
1279,26111,Michigan,Midland,1359,1580,105,221,116,0.524886877828054,Top 25th percentile
1280,26115,Michigan,Monroe,2650,3118,260,468,208,0.444444444444444,Top 25th percentile
1281,26117,Michigan,Montcalm,1110,1282,121,172,51,0.296511627906977,50th-75th percentile
1282,26121,Michigan,Muskegon,3042,3577,376,535,159,0.297196261682243,50th-75th percentile
1283,26123,Michigan,Newaygo,875,975,75,100,25,0.25,50th-75th percentile
1284,26127,Michigan,Oceana,468,553,66,85,19,0.223529411764706,25th-50th percentile
1285,26013,Michigan,Baraga,184,208,41,24,-17,-0.708333333333333,Bottom 25th percentile
1286,26053,Michigan,Gogebic,346,390,49,44,-5,-0.113636363636364,Bottom 25th percentile
1287,26061,Michigan,Houghton,638,653,49,15,-34,-2.26666666666667,Bottom 25th percentile
1288,26083,Michigan,Keweenaw,45,50,6,5,-1,-0.2,Bottom 25th percentile
1289,26131,Michigan,Ontonagon,168,202,25,34,9,0.264705882352941,50th-75th percentile
1290,26125,Michigan,Oakland,18794,21624,2180,2830,650,0.229681978798587,25th-50th percentile
1291,26139,Michigan,Ottawa,3604,4240,392,636,244,0.383647798742138,50th-75th percentile
1292,26145,Michigan,Saginaw,3715,4454,552,739,187,0.253044654939107,50th-75th percentile
1293,26147,Michigan,St. Clair,3094,3688,418,594,176,0.296296296296296,50th-75th percentile
1294,26149,Michigan,St. Joseph,1158,1272,104,114,10,0.087719298245614,25th-50th percentile
1295,26155,Michigan,Shiawassee,1307,1454,119,147,28,0.19047619047619,25th-50th percentile
1296,26157,Michigan,Tuscola,1084,1309,169,225,56,0.248888888888889,50th-75th percentile
1297,26159,Michigan,Van Buren,1342,1566,157,224,67,0.299107142857143,50th-75th percentile
1298,26161,Michigan,Washtenaw,4035,4413,282,378,96,0.253968253968254,50th-75th percentile
1299,26163,Michigan,Wayne,30808,36886,4629,6078,1449,0.238400789733465,25th-50th percentile
1300,27001,Minnesota,Aitkin,392,426,42,34,-8,-0.235294117647059,Bottom 25th percentile
1301,27061,Minnesota,Itasca,904,1002,73,98,25,0.255102040816327,50th-75th percentile
1302,27003,Minnesota,Anoka,3928,4557,494,629,135,0.214626391096979,25th-50th percentile
1303,27005,Minnesota,Becker,654,726,67,72,5,0.0694444444444445,25th-50th percentile
1304,27057,Minnesota,Hubbard,404,435,40,31,-9,-0.290322580645161,Bottom 25th percentile
1305,27087,Minnesota,Mahnomen,108,128,6,20,14,0.7,Top 25th percentile
1306,27107,Minnesota,Norman,169,140,8,-29,-37,1.27586206896552,Top 25th percentile
1307,27007,Minnesota,Beltrami,692,832,72,140,68,0.485714285714286,Top 25th percentile
1308,27029,Minnesota,Clearwater,172,184,14,12,-2,-0.166666666666667,Bottom 25th percentile
1309,27009,Minnesota,Benton,667,740,91,73,-18,-0.246575342465753,Bottom 25th percentile
1310,27145,Minnesota,Stearns,1926,2192,252,266,14,0.0526315789473684,25th-50th percentile
1311,27013,Minnesota,Blue Earth,886,930,50,44,-6,-0.136363636363636,Bottom 25th percentile
1312,27043,Minnesota,Faribault,335,335,15,0,-15,-inf,Bottom 25th percentile
1313,27091,Minnesota,Martin,440,467,37,27,-10,-0.37037037037037,Bottom 25th percentile
1314,27165,Minnesota,Watonwan,204,242,11,38,27,0.710526315789474,Top 25th percentile
1315,27015,Minnesota,Brown,519,578,46,59,13,0.220338983050847,25th-50th percentile
1316,27079,Minnesota,Le Sueur,436,453,40,17,-23,-1.35294117647059,Bottom 25th percentile
1317,27103,Minnesota,Nicollet,469,468,45,-1,-46,46.0,Top 25th percentile
1318,27019,Minnesota,Carver,978,1050,59,72,13,0.180555555555556,25th-50th percentile
1319,27021,Minnesota,Cass,578,647,45,69,24,0.347826086956522,50th-75th percentile
1320,27035,Minnesota,Crow Wing,1233,1309,107,76,-31,-0.407894736842105,Bottom 25th percentile
1321,27025,Minnesota,Chisago,802,879,54,77,23,0.298701298701299,50th-75th percentile
1322,27059,Minnesota,Isanti,598,660,67,62,-5,-0.0806451612903226,Bottom 25th percentile
1323,27027,Minnesota,Clay,865,914,99,49,-50,-1.02040816326531,Bottom 25th percentile
1324,27037,Minnesota,Dakota,4667,5320,493,653,160,0.245022970903522,50th-75th percentile
1325,27039,Minnesota,Dodge,279,267,11,-12,-23,1.91666666666667,Top 25th percentile
1326,27147,Minnesota,Steele,559,627,22,68,46,0.676470588235294,Top 25th percentile
1327,27161,Minnesota,Waseca,342,327,28,-15,-43,2.86666666666667,Top 25th percentile
1328,27041,Minnesota,Douglas,784,831,83,47,-36,-0.765957446808511,Bottom 25th percentile
1329,27097,Minnesota,Morrison,555,681,63,126,63,0.5,Top 25th percentile
1330,27153,Minnesota,Todd,377,403,41,26,-15,-0.576923076923077,Bottom 25th percentile
1331,27045,Minnesota,Fillmore,412,413,13,1,-12,-12.0,Bottom 25th percentile
1332,27055,Minnesota,Houston,337,366,18,29,11,0.379310344827586,50th-75th percentile
1333,27169,Minnesota,Winona,747,765,51,18,-33,-1.83333333333333,Bottom 25th percentile
1334,27047,Minnesota,Freeborn,633,656,31,23,-8,-0.347826086956522,Bottom 25th percentile
1335,27099,Minnesota,Mower,730,717,40,-13,-53,4.07692307692308,Top 25th percentile
1336,27049,Minnesota,Goodhue,850,963,72,113,41,0.36283185840708,50th-75th percentile
1337,27157,Minnesota,Wabasha,357,364,10,7,-3,-0.428571428571429,Bottom 25th percentile
1338,27053,Minnesota,Hennepin,15233,16772,1708,1539,-169,-0.109811565951917,Bottom 25th percentile
1339,27065,Minnesota,Kanabec,299,345,27,46,19,0.41304347826087,Top 25th percentile
1340,27095,Minnesota,Mille Lacs,515,603,64,88,24,0.272727272727273,50th-75th percentile
1341,27115,Minnesota,Pine,511,602,39,91,52,0.571428571428571,Top 25th percentile
1342,27067,Minnesota,Kandiyohi,685,791,97,106,9,0.0849056603773585,25th-50th percentile
1343,27129,Minnesota,Renville,327,342,39,15,-24,-1.6,Bottom 25th percentile
1344,27085,Minnesota,McLeod,597,736,63,139,76,0.546762589928058,Top 25th percentile
1345,27093,Minnesota,Meeker,410,437,45,27,-18,-0.666666666666667,Bottom 25th percentile
1346,27143,Minnesota,Sibley,252,240,8,-12,-20,1.66666666666667,Top 25th percentile
1347,27069,Minnesota,Kittson,106,126,24,20,-4,-0.2,Bottom 25th percentile
1348,27077,Minnesota,Lake of the Woods,81,92,10,11,1,0.0909090909090909,25th-50th percentile
1349,27089,Minnesota,Marshall,151,177,19,26,7,0.269230769230769,50th-75th percentile
1350,27113,Minnesota,Pennington,240,231,25,-9,-34,3.77777777777778,Top 25th percentile
1351,27119,Minnesota,Polk,626,687,81,61,-20,-0.327868852459016,Bottom 25th percentile
1352,27125,Minnesota,Red Lake,58,59,8,1,-7,-7.0,Bottom 25th percentile
1353,27135,Minnesota,Roseau,247,309,22,62,40,0.645161290322581,Top 25th percentile
1354,27109,Minnesota,Olmsted,1945,2140,89,195,106,0.543589743589744,Top 25th percentile
1355,27111,Minnesota,Otter Tail,1180,1342,99,162,63,0.388888888888889,50th-75th percentile
1356,27159,Minnesota,Wadena,372,345,26,-27,-53,1.96296296296296,Top 25th percentile
1357,27167,Minnesota,Wilkin,144,155,16,11,-5,-0.454545454545455,Bottom 25th percentile
1358,27123,Minnesota,Ramsey,7407,8232,850,825,-25,-0.0303030303030303,25th-50th percentile
1359,27131,Minnesota,Rice,923,1019,110,96,-14,-0.145833333333333,Bottom 25th percentile
1360,27017,Minnesota,Carlton,661,745,63,84,21,0.25,50th-75th percentile
1361,27031,Minnesota,Cook,92,86,5,-6,-11,1.83333333333333,Top 25th percentile
1362,27071,Minnesota,Koochiching,258,294,14,36,22,0.611111111111111,Top 25th percentile
1363,27075,Minnesota,Lake,247,282,18,35,17,0.485714285714286,Top 25th percentile
1364,27137,Minnesota,St. Louis,3560,4035,330,475,145,0.305263157894737,50th-75th percentile
1365,27139,Minnesota,Scott,1275,1459,129,184,55,0.298913043478261,50th-75th percentile
1366,27141,Minnesota,Sherburne,988,1173,104,185,81,0.437837837837838,Top 25th percentile
1367,27033,Minnesota,Cottonwood,246,304,27,58,31,0.53448275862069,Top 25th percentile
1368,27063,Minnesota,Jackson,189,191,19,2,-17,-8.5,Bottom 25th percentile
1369,27101,Minnesota,Murray,169,142,6,-27,-33,1.22222222222222,Top 25th percentile
1370,27105,Minnesota,Nobles,328,357,55,29,-26,-0.896551724137931,Bottom 25th percentile
1371,27117,Minnesota,Pipestone,212,222,19,10,-9,-0.9,Bottom 25th percentile
1372,27133,Minnesota,Rock,205,233,23,28,5,0.178571428571429,25th-50th percentile
1373,27011,Minnesota,Big Stone,138,128,4,-10,-14,1.4,Top 25th percentile
1374,27023,Minnesota,Chippewa,304,288,32,-16,-48,3.0,Top 25th percentile
1375,27051,Minnesota,Grant,126,121,7,-5,-12,2.4,Top 25th percentile
1376,27121,Minnesota,Pope,239,230,16,-9,-25,2.77777777777778,Top 25th percentile
1377,27149,Minnesota,Stevens,158,145,11,-13,-24,1.84615384615385,Top 25th percentile
1378,27151,Minnesota,Swift,207,199,24,-8,-32,4.0,Top 25th percentile
1379,27155,Minnesota,Traverse,98,102,15,4,-11,-2.75,Bottom 25th percentile
1380,27163,Minnesota,Washington,3032,3366,292,334,42,0.125748502994012,25th-50th percentile
1381,27171,Minnesota,Wright,1539,1711,162,172,10,0.0581395348837209,25th-50th percentile
1382,27073,Minnesota,Lac Qui Parle,146,184,18,38,20,0.526315789473684,Top 25th percentile
1383,27081,Minnesota,Lincoln,143,160,11,17,6,0.352941176470588,50th-75th percentile
1384,27083,Minnesota,Lyon,387,423,46,36,-10,-0.277777777777778,Bottom 25th percentile
1385,27127,Minnesota,Redwood,319,342,33,23,-10,-0.434782608695652,Bottom 25th percentile
1386,27173,Minnesota,Yellow Medicine,191,188,24,-3,-27,9.0,Top 25th percentile
1387,28001,Mississippi,Adams,680,813,119,133,14,0.105263157894737,25th-50th percentile
1388,28005,Mississippi,Amite,316,350,50,34,-16,-0.470588235294118,Bottom 25th percentile
1389,28157,Mississippi,Wilkinson,207,230,34,23,-11,-0.478260869565217,Bottom 25th percentile
1390,28003,Mississippi,Alcorn,813,939,99,126,27,0.214285714285714,25th-50th percentile
1391,28117,Mississippi,Prentiss,545,658,81,113,32,0.283185840707965,50th-75th percentile
1392,28141,Mississippi,Tishomingo,497,644,76,147,71,0.482993197278912,Top 25th percentile
1393,28007,Mississippi,Attala,455,540,66,85,19,0.223529411764706,25th-50th percentile
1394,28019,Mississippi,Choctaw,188,212,22,24,2,0.0833333333333333,25th-50th percentile
1395,28079,Mississippi,Leake,405,527,98,122,24,0.19672131147541,25th-50th percentile
1396,28155,Mississippi,Webster,282,326,42,44,2,0.0454545454545455,25th-50th percentile
1397,28009,Mississippi,Benton,188,234,40,46,6,0.130434782608696,25th-50th percentile
1398,28093,Mississippi,Marshall,705,928,108,223,115,0.515695067264574,Top 25th percentile
1399,28139,Mississippi,Tippah,470,573,81,103,22,0.213592233009709,25th-50th percentile
1400,28011,Mississippi,Bolivar,692,911,136,219,83,0.378995433789954,50th-75th percentile
1401,28133,Mississippi,Sunflower,530,720,95,190,95,0.5,Top 25th percentile
1402,28013,Mississippi,Calhoun,323,407,51,84,33,0.392857142857143,50th-75th percentile
1403,28017,Mississippi,Chickasaw,352,414,60,62,2,0.032258064516129,25th-50th percentile
1404,28043,Mississippi,Grenada,521,644,84,123,39,0.317073170731707,50th-75th percentile
1405,28015,Mississippi,Carroll,196,267,42,71,29,0.408450704225352,50th-75th percentile
1406,28083,Mississippi,Leflore,607,854,129,247,118,0.477732793522267,Top 25th percentile
1407,28097,Mississippi,Montgomery,276,334,60,58,-2,-0.0344827586206897,25th-50th percentile
1408,28021,Mississippi,Claiborne,181,222,36,41,5,0.121951219512195,25th-50th percentile
1409,28063,Mississippi,Jefferson,145,185,36,40,4,0.1,25th-50th percentile
1410,28149,Mississippi,Warren,878,1134,181,256,75,0.29296875,50th-75th percentile
1411,28023,Mississippi,Clarke,371,432,79,61,-18,-0.295081967213115,Bottom 25th percentile
1412,28061,Mississippi,Jasper,354,484,56,130,74,0.569230769230769,Top 25th percentile
1413,28153,Mississippi,Wayne,382,472,68,90,22,0.244444444444444,50th-75th percentile
1414,28025,Mississippi,Clay,411,489,70,78,8,0.102564102564103,25th-50th percentile
1415,28105,Mississippi,Oktibbeha,565,746,130,181,51,0.281767955801105,50th-75th percentile
1416,28027,Mississippi,Coahoma,483,671,107,188,81,0.430851063829787,Top 25th percentile
1417,28119,Mississippi,Quitman,157,229,31,72,41,0.569444444444445,Top 25th percentile
1418,28135,Mississippi,Tallahatchie,307,344,54,37,-17,-0.45945945945946,Bottom 25th percentile
1419,28143,Mississippi,Tunica,186,263,36,77,41,0.532467532467532,Top 25th percentile
1420,28029,Mississippi,Copiah,561,700,86,139,53,0.381294964028777,50th-75th percentile
1421,28037,Mississippi,Franklin,169,229,26,60,34,0.566666666666667,Top 25th percentile
1422,28085,Mississippi,Lincoln,726,914,128,188,60,0.319148936170213,50th-75th percentile
1423,28031,Mississippi,Covington,440,556,78,116,38,0.327586206896552,50th-75th percentile
1424,28127,Mississippi,Simpson,523,708,116,185,69,0.372972972972973,50th-75th percentile
1425,28129,Mississippi,Smith,310,366,45,56,11,0.196428571428571,25th-50th percentile
1426,28033,Mississippi,De Soto,2556,3229,402,673,271,0.402674591381872,50th-75th percentile
1427,28035,Mississippi,Forrest,1351,1688,225,337,112,0.332344213649852,50th-75th percentile
1428,28039,Mississippi,George,491,590,78,99,21,0.212121212121212,25th-50th percentile
1429,28041,Mississippi,Greene,247,275,39,28,-11,-0.392857142857143,Bottom 25th percentile
1430,28111,Mississippi,Perry,281,351,48,70,22,0.314285714285714,50th-75th percentile
1431,28131,Mississippi,Stone,351,467,60,116,56,0.482758620689655,Top 25th percentile
1432,28045,Mississippi,Hancock,901,1086,130,185,55,0.297297297297297,50th-75th percentile
1433,28047,Mississippi,Harrison,3703,4512,478,809,331,0.409147095179234,50th-75th percentile
1434,28049,Mississippi,Hinds,3675,4720,578,1045,467,0.44688995215311,Top 25th percentile
1435,28057,Mississippi,Itawamba,514,628,91,114,23,0.201754385964912,25th-50th percentile
1436,28095,Mississippi,Monroe,773,989,157,216,59,0.273148148148148,50th-75th percentile
1437,28059,Mississippi,Jackson,2479,2902,339,423,84,0.198581560283688,25th-50th percentile
1438,28065,Mississippi,Jefferson Davis,285,294,37,9,-28,-3.11111111111111,Bottom 25th percentile
1439,28077,Mississippi,Lawrence,309,342,41,33,-8,-0.242424242424242,Bottom 25th percentile
1440,28091,Mississippi,Marion,554,729,99,175,76,0.434285714285714,Top 25th percentile
1441,28067,Mississippi,Jones,1360,1675,219,315,96,0.304761904761905,50th-75th percentile
1442,28069,Mississippi,Kemper,184,229,38,45,7,0.155555555555556,25th-50th percentile
1443,28099,Mississippi,Neshoba,691,903,183,212,29,0.136792452830189,25th-50th percentile
1444,28103,Mississippi,Noxubee,211,263,35,52,17,0.326923076923077,50th-75th percentile
1445,28159,Mississippi,Winston,399,517,85,118,33,0.279661016949153,50th-75th percentile
1446,28071,Mississippi,Lafayette,681,844,101,163,62,0.380368098159509,50th-75th percentile
1447,28161,Mississippi,Yalobusha,334,361,37,27,-10,-0.37037037037037,Bottom 25th percentile
1448,28073,Mississippi,Lamar,785,961,138,176,38,0.215909090909091,25th-50th percentile
1449,28075,Mississippi,Lauderdale,1468,1948,289,480,191,0.397916666666667,50th-75th percentile
1450,28101,Mississippi,Newton,447,559,80,112,32,0.285714285714286,50th-75th percentile
1451,28081,Mississippi,Lee,1588,1926,243,338,95,0.281065088757396,50th-75th percentile
1452,28087,Mississippi,Lowndes,1119,1323,166,204,38,0.186274509803922,25th-50th percentile
1453,28089,Mississippi,Madison,1843,2032,251,189,-62,-0.328042328042328,Bottom 25th percentile
1454,28107,Mississippi,Panola,666,828,121,162,41,0.253086419753086,50th-75th percentile
1455,28137,Mississippi,Tate,510,711,109,201,92,0.45771144278607,Top 25th percentile
1456,28109,Mississippi,Pearl River,1193,1507,232,314,82,0.261146496815287,50th-75th percentile
1457,28113,Mississippi,Pike,890,1091,134,201,67,0.333333333333333,50th-75th percentile
1458,28147,Mississippi,Walthall,329,390,58,61,3,0.0491803278688525,25th-50th percentile
1459,28115,Mississippi,Pontotoc,534,750,93,216,123,0.569444444444445,Top 25th percentile
1460,28145,Mississippi,Union,551,617,82,66,-16,-0.242424242424242,Bottom 25th percentile
1461,28121,Mississippi,Rankin,2146,2775,336,629,293,0.465818759936407,Top 25th percentile
1462,28123,Mississippi,Scott,518,638,91,120,29,0.241666666666667,25th-50th percentile
1463,28151,Mississippi,Washington,959,1294,139,335,196,0.585074626865672,Top 25th percentile
1464,28051,Mississippi,Holmes,356,504,86,148,62,0.418918918918919,Top 25th percentile
1465,28053,Mississippi,Humphreys,174,230,38,56,18,0.321428571428571,50th-75th percentile
1466,28055,Mississippi,Issaquena,28,24,2,-4,-6,1.5,Top 25th percentile
1467,28125,Mississippi,Sharkey,105,133,21,28,7,0.25,50th-75th percentile
1468,28163,Mississippi,Yazoo,493,600,69,107,38,0.355140186915888,50th-75th percentile
1469,29003,Missouri,Andrew,325,341,28,16,-12,-0.75,Bottom 25th percentile
1470,29005,Missouri,Atchison,130,164,14,34,20,0.588235294117647,Top 25th percentile
1471,29087,Missouri,Holt,100,142,23,42,19,0.452380952380952,Top 25th percentile
1472,29147,Missouri,Nodaway,343,316,30,-27,-57,2.11111111111111,Top 25th percentile
1473,29007,Missouri,Audrain,541,618,65,77,12,0.155844155844156,25th-50th percentile
1474,29027,Missouri,Callaway,734,887,86,153,67,0.437908496732026,Top 25th percentile
1475,29009,Missouri,Barry,772,879,91,107,16,0.149532710280374,25th-50th percentile
1476,29109,Missouri,Lawrence,858,973,106,115,9,0.0782608695652174,25th-50th percentile
1477,29119,Missouri,McDonald,422,515,59,93,34,0.365591397849462,50th-75th percentile
1478,29015,Missouri,Benton,533,625,55,92,37,0.402173913043478,50th-75th percentile
1479,29083,Missouri,Henry,513,595,62,82,20,0.24390243902439,50th-75th percentile
1480,29185,Missouri,St. Clair,248,264,21,16,-5,-0.3125,Bottom 25th percentile
1481,29017,Missouri,Bollinger,274,287,22,13,-9,-0.692307692307692,Bottom 25th percentile
1482,29123,Missouri,Madison,317,364,42,47,5,0.106382978723404,25th-50th percentile
1483,29207,Missouri,Stoddard,681,803,108,122,14,0.114754098360656,25th-50th percentile
1484,29223,Missouri,Wayne,330,396,32,66,34,0.515151515151515,Top 25th percentile
1485,29019,Missouri,Boone,2041,2343,159,302,143,0.473509933774834,Top 25th percentile
1486,29021,Missouri,Buchanan,1621,1909,178,288,110,0.381944444444444,50th-75th percentile
1487,29023,Missouri,Butler,1008,1194,116,186,70,0.376344086021505,50th-75th percentile
1488,29035,Missouri,Carter,143,169,13,26,13,0.5,Top 25th percentile
1489,29181,Missouri,Ripley,328,382,47,54,7,0.12962962962963,25th-50th percentile
1490,29029,Missouri,Camden,871,1114,133,243,110,0.452674897119342,Top 25th percentile
1491,29131,Missouri,Miller,511,619,69,108,39,0.361111111111111,50th-75th percentile
1492,29135,Missouri,Moniteau,288,323,34,35,1,0.0285714285714286,25th-50th percentile
1493,29141,Missouri,Morgan,531,576,59,45,-14,-0.311111111111111,Bottom 25th percentile
1494,29031,Missouri,Cape Girardeau,1410,1735,166,325,159,0.489230769230769,Top 25th percentile
1495,29157,Missouri,Perry,364,426,32,62,30,0.483870967741936,Top 25th percentile
1496,29033,Missouri,Carroll,190,208,36,18,-18,-1.0,Bottom 25th percentile
1497,29107,Missouri,Lafayette,688,786,72,98,26,0.26530612244898,50th-75th percentile
1498,29177,Missouri,Ray,451,583,63,132,69,0.522727272727273,Top 25th percentile
1499,29037,Missouri,Cass,1748,1994,177,246,69,0.280487804878049,50th-75th percentile
1500,29043,Missouri,Christian,1246,1530,197,284,87,0.306338028169014,50th-75th percentile
1501,29047,Missouri,Clay,3249,3699,408,450,42,0.0933333333333333,25th-50th percentile
1502,29051,Missouri,Cole,1182,1440,196,258,62,0.24031007751938,25th-50th percentile
1503,29055,Missouri,Crawford,528,629,73,101,28,0.277227722772277,50th-75th percentile
1504,29093,Missouri,Iron,287,320,25,33,8,0.242424242424242,50th-75th percentile
1505,29179,Missouri,Reynolds,148,173,6,25,19,0.76,Top 25th percentile
1506,29221,Missouri,Washington,503,634,81,131,50,0.381679389312977,50th-75th percentile
1507,29059,Missouri,Dallas,380,537,53,157,104,0.662420382165605,Top 25th percentile
1508,29085,Missouri,Hickory,262,308,32,46,14,0.304347826086957,50th-75th percentile
1509,29167,Missouri,Polk,650,734,82,84,2,0.0238095238095238,25th-50th percentile
1510,29025,Missouri,Caldwell,177,214,17,37,20,0.540540540540541,Top 25th percentile
1511,29049,Missouri,Clinton,456,500,61,44,-17,-0.386363636363636,Bottom 25th percentile
1512,29061,Missouri,Daviess,157,189,18,32,14,0.4375,Top 25th percentile
1513,29063,Missouri,DeKalb,193,244,27,51,24,0.470588235294118,Top 25th percentile
1514,29075,Missouri,Gentry,157,191,15,34,19,0.558823529411765,Top 25th percentile
1515,29081,Missouri,Harrison,194,207,17,13,-4,-0.307692307692308,Bottom 25th percentile
1516,29227,Missouri,Worth,52,48,11,-4,-15,3.75,Top 25th percentile
1517,29065,Missouri,Dent,348,457,70,109,39,0.357798165137615,50th-75th percentile
1518,29161,Missouri,Phelps,799,1004,138,205,67,0.326829268292683,50th-75th percentile
1519,29067,Missouri,Douglas,356,379,56,23,-33,-1.43478260869565,Bottom 25th percentile
1520,29153,Missouri,Ozark,222,296,41,74,33,0.445945945945946,Top 25th percentile
1521,29215,Missouri,Texas,556,658,52,102,50,0.490196078431373,Top 25th percentile
1522,29229,Missouri,Wright,462,438,64,-24,-88,3.66666666666667,Top 25th percentile
1523,29069,Missouri,Dunklin,746,940,96,194,98,0.505154639175258,Top 25th percentile
1524,29155,Missouri,Pemiscot,390,506,54,116,62,0.53448275862069,Top 25th percentile
1525,29071,Missouri,Franklin,1788,2113,247,325,78,0.24,25th-50th percentile
1526,29073,Missouri,Gasconade,367,442,68,75,7,0.0933333333333333,25th-50th percentile
1527,29139,Missouri,Montgomery,316,321,29,5,-24,-4.8,Bottom 25th percentile
1528,29219,Missouri,Warren,553,687,72,134,62,0.462686567164179,Top 25th percentile
1529,29077,Missouri,Greene,5098,5854,714,756,42,0.0555555555555556,25th-50th percentile
1530,29079,Missouri,Grundy,218,254,50,36,-14,-0.388888888888889,Bottom 25th percentile
1531,29115,Missouri,Linn,307,333,47,26,-21,-0.807692307692308,Bottom 25th percentile
1532,29117,Missouri,Livingston,316,354,66,38,-28,-0.736842105263158,Bottom 25th percentile
1533,29129,Missouri,Mercer,79,103,15,24,9,0.375,50th-75th percentile
1534,29171,Missouri,Putnam,125,130,11,5,-6,-1.2,Bottom 25th percentile
1535,29211,Missouri,Sullivan,117,144,13,27,14,0.518518518518519,Top 25th percentile
1536,29091,Missouri,Howell,899,1111,151,212,61,0.287735849056604,50th-75th percentile
1537,29149,Missouri,Oregon,250,284,20,34,14,0.411764705882353,50th-75th percentile
1538,29203,Missouri,Shannon,169,228,26,59,33,0.559322033898305,Top 25th percentile
1539,29095,Missouri,Jackson,10839,12579,1197,1740,543,0.312068965517241,50th-75th percentile
1540,29097,Missouri,Jasper,2180,2610,363,430,67,0.155813953488372,25th-50th percentile
1541,29099,Missouri,Jefferson,3518,3999,398,481,83,0.172557172557173,25th-50th percentile
1542,29101,Missouri,Johnson,736,900,93,164,71,0.432926829268293,Top 25th percentile
1543,29105,Missouri,Laclede,772,909,115,137,22,0.160583941605839,25th-50th percentile
1544,29225,Missouri,Webster,629,796,106,167,61,0.365269461077844,50th-75th percentile
1545,29113,Missouri,Lincoln,876,959,94,83,-11,-0.132530120481928,Bottom 25th percentile
1546,29163,Missouri,Pike,349,386,45,37,-8,-0.216216216216216,Bottom 25th percentile
1547,29125,Missouri,Maries,181,242,20,61,41,0.672131147540984,Top 25th percentile
1548,29151,Missouri,Osage,231,257,28,26,-2,-0.0769230769230769,Bottom 25th percentile
1549,29169,Missouri,Pulaski,559,693,82,134,52,0.388059701492537,50th-75th percentile
1550,29127,Missouri,Marion,606,655,80,49,-31,-0.63265306122449,Bottom 25th percentile
1551,29137,Missouri,Monroe,186,209,26,23,-3,-0.130434782608696,Bottom 25th percentile
1552,29173,Missouri,Ralls,169,236,19,67,48,0.716417910447761,Top 25th percentile
1553,29205,Missouri,Shelby,139,162,13,23,10,0.434782608695652,Top 25th percentile
1554,29133,Missouri,Mississippi,310,380,46,70,24,0.342857142857143,50th-75th percentile
1555,29143,Missouri,New Madrid,417,546,58,129,71,0.550387596899225,Top 25th percentile
1556,29201,Missouri,Scott,792,985,101,193,92,0.476683937823834,Top 25th percentile
1557,29145,Missouri,Newton,1164,1332,184,168,-16,-0.0952380952380952,Bottom 25th percentile
1558,29159,Missouri,Pettis,798,954,91,156,65,0.416666666666667,Top 25th percentile
1559,29195,Missouri,Saline,453,543,72,90,18,0.2,25th-50th percentile
1560,29165,Missouri,Platte,1300,1469,138,169,31,0.183431952662722,25th-50th percentile
1561,29041,Missouri,Chariton,170,221,27,51,24,0.470588235294118,Top 25th percentile
1562,29053,Missouri,Cooper,356,368,42,12,-30,-2.5,Bottom 25th percentile
1563,29089,Missouri,Howard,186,215,7,29,22,0.758620689655172,Top 25th percentile
1564,29121,Missouri,Macon,368,432,28,64,36,0.5625,Top 25th percentile
1565,29175,Missouri,Randolph,509,607,67,98,31,0.316326530612245,50th-75th percentile
1566,29183,Missouri,St. Charles,5157,6212,639,1055,416,0.394312796208531,50th-75th percentile
1567,29186,Missouri,Ste. Genevieve,350,369,34,19,-15,-0.789473684210526,Bottom 25th percentile
1568,29187,Missouri,St. Francois,1338,1661,189,323,134,0.414860681114551,Top 25th percentile
1569,29510,Missouri,St. Louis (city),4660,5433,564,773,209,0.270375161707633,50th-75th percentile
1570,29189,Missouri,St. Louis (county),17618,20193,2113,2575,462,0.179417475728155,25th-50th percentile
1571,29001,Missouri,Adair,400,456,35,56,21,0.375,50th-75th percentile
1572,29045,Missouri,Clark,141,171,27,30,3,0.1,25th-50th percentile
1573,29103,Missouri,Knox,78,99,9,21,12,0.571428571428571,Top 25th percentile
1574,29111,Missouri,Lewis,204,239,18,35,17,0.485714285714286,Top 25th percentile
1575,29197,Missouri,Schuyler,89,109,26,20,-6,-0.3,Bottom 25th percentile
1576,29199,Missouri,Scotland,95,110,16,15,-1,-0.0666666666666667,Bottom 25th percentile
1577,29209,Missouri,Stone,720,822,105,102,-3,-0.0294117647058824,25th-50th percentile
1578,29213,Missouri,Taney,1086,1288,162,202,40,0.198019801980198,25th-50th percentile
1579,29011,Missouri,Barton,249,270,39,21,-18,-0.857142857142857,Bottom 25th percentile
1580,29013,Missouri,Bates,357,402,47,45,-2,-0.0444444444444444,25th-50th percentile
1581,29039,Missouri,Cedar,381,355,45,-26,-71,2.73076923076923,Top 25th percentile
1582,29057,Missouri,Dade,190,218,38,28,-10,-0.357142857142857,Bottom 25th percentile
1583,29217,Missouri,Vernon,424,534,67,110,43,0.390909090909091,50th-75th percentile
1584,30001,Montana,Beaverhead,154,201,16,47,31,0.659574468085106,Top 25th percentile
1585,30031,Montana,Gallatin,1322,1385,103,63,-40,-0.634920634920635,Bottom 25th percentile
1586,30057,Montana,Madison,157,182,17,25,8,0.32,50th-75th percentile
1587,30013,Montana,Cascade,1522,1773,219,251,32,0.127490039840637,25th-50th percentile
1588,30023,Montana,Deer Lodge,208,231,13,23,10,0.434782608695652,Top 25th percentile
1589,30039,Montana,Granite,56,58,9,2,-7,-3.5,Bottom 25th percentile
1590,30077,Montana,Powell,135,149,13,14,1,0.0714285714285714,25th-50th percentile
1591,30081,Montana,Ravalli,851,1008,111,157,46,0.292993630573248,50th-75th percentile
1592,30093,Montana,Silver Bow,738,835,89,97,8,0.0824742268041237,25th-50th percentile
1593,30003,Montana,Big Horn,222,308,79,86,7,0.0813953488372093,25th-50th percentile
1594,30011,Montana,Carter,28,27,9,-1,-10,10.0,Top 25th percentile
1595,30017,Montana,Custer,237,249,34,12,-22,-1.83333333333333,Bottom 25th percentile
1596,30019,Montana,Daniels,36,43,10,7,-3,-0.428571428571429,Bottom 25th percentile
1597,30021,Montana,Dawson,160,233,38,73,35,0.479452054794521,Top 25th percentile
1598,30025,Montana,Fallon,53,62,8,9,1,0.111111111111111,25th-50th percentile
1599,30033,Montana,Garfield,29,29,8,0,-8,-inf,Bottom 25th percentile
1600,30055,Montana,McCone,32,25,7,-7,-14,2.0,Top 25th percentile
1601,30071,Montana,Phillips,89,103,15,14,-1,-0.0714285714285714,Bottom 25th percentile
1602,30075,Montana,Powder River,34,38,3,4,1,0.25,50th-75th percentile
1603,30079,Montana,Prairie,33,25,8,-8,-16,2.0,Top 25th percentile
1604,30083,Montana,Richland,155,191,18,36,18,0.5,Top 25th percentile
1605,30085,Montana,Roosevelt,210,305,55,95,40,0.421052631578947,Top 25th percentile
1606,30087,Montana,Rosebud,146,216,54,70,16,0.228571428571429,25th-50th percentile
1607,30091,Montana,Sheridan,77,74,8,-3,-11,3.66666666666667,Top 25th percentile
1608,30103,Montana,Treasure,20,9,9,-11,-20,1.81818181818182,Top 25th percentile
1609,30105,Montana,Valley,152,168,27,16,-11,-0.6875,Bottom 25th percentile
1610,30109,Montana,Wibaux,27,40,9,13,4,0.307692307692308,50th-75th percentile
1611,30029,Montana,Flathead,1658,1974,173,316,143,0.45253164556962,Top 25th percentile
1612,30043,Montana,Jefferson,178,272,19,94,75,0.797872340425532,Top 25th percentile
1613,30049,Montana,Lewis and Clark,1100,1249,130,149,19,0.12751677852349,25th-50th percentile
1614,30047,Montana,Lake,538,628,67,90,23,0.255555555555556,50th-75th percentile
1615,30053,Montana,Lincoln,440,507,49,67,18,0.26865671641791,50th-75th percentile
1616,30061,Montana,Mineral,97,124,17,27,10,0.37037037037037,50th-75th percentile
1617,30089,Montana,Sanders,297,341,38,44,6,0.136363636363636,25th-50th percentile
1618,30063,Montana,Missoula,1583,1719,136,136,0,0.0,25th-50th percentile
1619,30005,Montana,Blaine,109,156,31,47,16,0.340425531914894,50th-75th percentile
1620,30015,Montana,Chouteau,98,118,5,20,15,0.75,Top 25th percentile
1621,30027,Montana,Fergus,261,290,32,29,-3,-0.103448275862069,Bottom 25th percentile
1622,30035,Montana,Glacier,231,295,56,64,8,0.125,25th-50th percentile
1623,30041,Montana,Hill,301,332,54,31,-23,-0.741935483870968,Bottom 25th percentile
1624,30045,Montana,Judith Basin,33,33,10,0,-10,-inf,Bottom 25th percentile
1625,30051,Montana,Liberty,33,32,10,-1,-11,11.0,Top 25th percentile
1626,30069,Montana,Petroleum,14,11,11,-3,-14,4.66666666666667,Top 25th percentile
1627,30073,Montana,Pondera,124,125,7,1,-6,-6.0,Bottom 25th percentile
1628,30099,Montana,Teton,109,137,7,28,21,0.75,Top 25th percentile
1629,30101,Montana,Toole,87,110,11,23,12,0.521739130434783,Top 25th percentile
1630,30007,Montana,Broadwater,111,129,26,18,-8,-0.444444444444444,Bottom 25th percentile
1631,30009,Montana,Carbon,179,201,24,22,-2,-0.0909090909090909,Bottom 25th percentile
1632,30037,Montana,Golden Valley,24,28,8,4,-4,-1.0,Bottom 25th percentile
1633,30059,Montana,Meagher,40,36,8,-4,-12,3.0,Top 25th percentile
1634,30065,Montana,Musselshell,98,125,15,27,12,0.444444444444444,Top 25th percentile
1635,30095,Montana,Stillwater,153,192,22,39,17,0.435897435897436,Top 25th percentile
1636,30097,Montana,Sweet Grass,64,80,12,16,4,0.25,50th-75th percentile
1637,30107,Montana,Wheatland,46,57,4,11,7,0.636363636363636,Top 25th percentile
1638,30111,Montana,Yellowstone,2735,3158,348,423,75,0.177304964539007,25th-50th percentile
1639,31007,Nebraska,Banner,21,7,7,-14,-21,1.5,Top 25th percentile
1640,31033,Nebraska,Cheyenne,167,211,24,44,20,0.454545454545455,Top 25th percentile
1641,31105,Nebraska,Kimball,92,102,9,10,1,0.1,25th-50th percentile
1642,31123,Nebraska,Morrill,102,122,13,20,7,0.35,50th-75th percentile
1643,31157,Nebraska,Scotts Bluff,736,843,119,107,-12,-0.11214953271028,Bottom 25th percentile
1644,31019,Nebraska,Buffalo,653,749,81,96,15,0.15625,25th-50th percentile
1645,31099,Nebraska,Kearney,130,117,8,-13,-21,1.61538461538462,Top 25th percentile
1646,31163,Nebraska,Sherman,79,82,6,3,-3,-1.0,Bottom 25th percentile
1647,31021,Nebraska,Burt,163,157,16,-6,-22,3.66666666666667,Top 25th percentile
1648,31043,Nebraska,Dakota,311,356,71,45,-26,-0.577777777777778,Bottom 25th percentile
1649,31173,Nebraska,Thurston,144,175,24,31,7,0.225806451612903,25th-50th percentile
1650,31177,Nebraska,Washington,340,358,31,18,-13,-0.722222222222222,Bottom 25th percentile
1651,31027,Nebraska,Cedar,177,171,28,-6,-34,5.66666666666667,Top 25th percentile
1652,31037,Nebraska,Colfax,132,127,25,-5,-30,6.0,Top 25th percentile
1653,31039,Nebraska,Cuming,168,205,17,37,20,0.540540540540541,Top 25th percentile
1654,31051,Nebraska,Dixon,109,124,18,15,-3,-0.2,Bottom 25th percentile
1655,31167,Nebraska,Stanton,77,101,10,24,14,0.583333333333333,Top 25th percentile
1656,31179,Nebraska,Wayne,128,132,5,4,-1,-0.25,Bottom 25th percentile
1657,31053,Nebraska,Dodge,777,876,82,99,17,0.171717171717172,25th-50th percentile
1658,31155,Nebraska,Saunders,408,452,35,44,9,0.204545454545455,25th-50th percentile
1659,31055,Nebraska,Douglas,7429,8209,758,780,22,0.0282051282051282,25th-50th percentile
1660,31029,Nebraska,Chase,92,108,12,16,4,0.25,50th-75th percentile
1661,31047,Nebraska,Dawson,383,417,55,34,-21,-0.617647058823529,Bottom 25th percentile
1662,31057,Nebraska,Dundy,43,42,6,-1,-7,7.0,Top 25th percentile
1663,31063,Nebraska,Frontier,36,43,8,7,-1,-0.142857142857143,Bottom 25th percentile
1664,31073,Nebraska,Gosper,43,56,13,13,0,0.0,25th-50th percentile
1665,31085,Nebraska,Hayes,26,7,7,-19,-26,1.36842105263158,Top 25th percentile
1666,31087,Nebraska,Hitchcock,80,94,10,14,4,0.285714285714286,50th-75th percentile
1667,31145,Nebraska,Red Willow,238,273,6,35,29,0.828571428571429,Top 25th percentile
1668,31079,Nebraska,Hall,989,1060,147,71,-76,-1.07042253521127,Bottom 25th percentile
1669,31093,Nebraska,Howard,134,146,20,12,-8,-0.666666666666667,Bottom 25th percentile
1670,31121,Nebraska,Merrick,157,172,21,15,-6,-0.4,Bottom 25th percentile
1671,31125,Nebraska,Nance,98,101,7,3,-4,-1.33333333333333,Bottom 25th percentile
1672,31141,Nebraska,Platte,528,586,71,58,-13,-0.224137931034483,Bottom 25th percentile
1673,31109,Nebraska,Lancaster,4079,4353,285,274,-11,-0.0401459854014599,25th-50th percentile
1674,31049,Nebraska,Deuel,38,43,10,5,-5,-1.0,Bottom 25th percentile
1675,31101,Nebraska,Keith,166,192,13,26,13,0.5,Top 25th percentile
1676,31111,Nebraska,Lincoln,656,819,95,163,68,0.417177914110429,Top 25th percentile
1677,31113,Nebraska,Logan,15,18,12,3,-9,-3.0,Bottom 25th percentile
1678,31117,Nebraska,McPherson,13,10,10,-3,-13,4.33333333333333,Top 25th percentile
1679,31135,Nebraska,Perkins,60,62,14,2,-12,-6.0,Bottom 25th percentile
1680,31005,Nebraska,Arthur,14,14,14,0,-14,-inf,Bottom 25th percentile
1681,31009,Nebraska,Blaine,14,7,7,-7,-14,2.0,Top 25th percentile
1682,31013,Nebraska,Box Butte,198,227,17,29,12,0.413793103448276,Top 25th percentile
1683,31017,Nebraska,Brown,64,82,11,18,7,0.388888888888889,50th-75th percentile
1684,31031,Nebraska,Cherry,108,133,14,25,11,0.44,Top 25th percentile
1685,31041,Nebraska,Custer,208,243,21,35,14,0.4,50th-75th percentile
1686,31045,Nebraska,Dawes,149,177,20,28,8,0.285714285714286,50th-75th percentile
1687,31069,Nebraska,Garden,55,54,8,-1,-9,9.0,Top 25th percentile
1688,31075,Nebraska,Grant,15,20,11,5,-6,-1.2,Bottom 25th percentile
1689,31091,Nebraska,Hooker,27,18,9,-9,-18,2.0,Top 25th percentile
1690,31103,Nebraska,Keya Paha,18,13,9,-5,-14,2.8,Top 25th percentile
1691,31115,Nebraska,Loup,22,9,9,-13,-22,1.69230769230769,Top 25th percentile
1692,31149,Nebraska,Rock,41,37,9,-4,-13,3.25,Top 25th percentile
1693,31161,Nebraska,Sheridan,129,148,26,19,-7,-0.368421052631579,Bottom 25th percentile
1694,31165,Nebraska,Sioux,19,21,14,2,-12,-6.0,Bottom 25th percentile
1695,31171,Nebraska,Thomas,22,13,13,-9,-22,2.44444444444444,Top 25th percentile
1696,31059,Nebraska,Fillmore,143,135,15,-8,-23,2.875,Top 25th percentile
1697,31067,Nebraska,Gage,477,541,38,64,26,0.40625,50th-75th percentile
1698,31095,Nebraska,Jefferson,187,212,7,25,18,0.72,Top 25th percentile
1699,31129,Nebraska,Nuckolls,110,130,17,20,3,0.15,25th-50th percentile
1700,31151,Nebraska,Saline,259,204,10,-55,-65,1.18181818181818,Top 25th percentile
1701,31169,Nebraska,Thayer,141,148,11,7,-4,-0.571428571428571,Bottom 25th percentile
1702,31153,Nebraska,Sarpy,1870,2235,190,365,175,0.479452054794521,Top 25th percentile
1703,31001,Nebraska,Adams,552,637,60,85,25,0.294117647058824,50th-75th percentile
1704,31035,Nebraska,Clay,124,143,15,19,4,0.210526315789474,25th-50th percentile
1705,31061,Nebraska,Franklin,67,91,13,24,11,0.458333333333333,Top 25th percentile
1706,31065,Nebraska,Furnas,111,118,10,7,-3,-0.428571428571429,Bottom 25th percentile
1707,31083,Nebraska,Harlan,70,82,5,12,7,0.583333333333333,Top 25th percentile
1708,31137,Nebraska,Phelps,194,219,20,25,5,0.2,25th-50th percentile
1709,31181,Nebraska,Webster,100,111,14,11,-3,-0.272727272727273,Bottom 25th percentile
1710,31025,Nebraska,Cass,408,476,31,68,37,0.544117647058824,Top 25th percentile
1711,31097,Nebraska,Johnson,114,107,10,-7,-17,2.42857142857143,Top 25th percentile
1712,31127,Nebraska,Nemaha,148,162,18,14,-4,-0.285714285714286,Bottom 25th percentile
1713,31131,Nebraska,Otoe,327,311,17,-16,-33,2.0625,Top 25th percentile
1714,31133,Nebraska,Pawnee,62,72,10,10,0,0.0,25th-50th percentile
1715,31147,Nebraska,Richardson,206,253,25,47,22,0.468085106382979,Top 25th percentile
1716,31003,Nebraska,Antelope,130,149,17,19,2,0.105263157894737,25th-50th percentile
1717,31011,Nebraska,Boone,112,141,10,29,19,0.655172413793103,Top 25th percentile
1718,31015,Nebraska,Boyd,59,69,8,10,2,0.2,25th-50th percentile
1719,31071,Nebraska,Garfield,64,57,5,-7,-12,1.71428571428571,Top 25th percentile
1720,31077,Nebraska,Greeley,50,51,12,1,-11,-11.0,Bottom 25th percentile
1721,31089,Nebraska,Holt,219,220,22,1,-21,-21.0,Bottom 25th percentile
1722,31107,Nebraska,Knox,180,224,18,44,26,0.590909090909091,Top 25th percentile
1723,31119,Nebraska,Madison,650,624,51,-26,-77,2.96153846153846,Top 25th percentile
1724,31139,Nebraska,Pierce,126,136,21,10,-11,-1.1,Bottom 25th percentile
1725,31175,Nebraska,Valley,90,104,10,14,4,0.285714285714286,50th-75th percentile
1726,31183,Nebraska,Wheeler,23,11,11,-12,-23,1.91666666666667,Top 25th percentile
1727,31023,Nebraska,Butler,189,171,17,-18,-35,1.94444444444444,Top 25th percentile
1728,31081,Nebraska,Hamilton,152,197,21,45,24,0.533333333333333,Top 25th percentile
1729,31143,Nebraska,Polk,103,129,13,26,13,0.5,Top 25th percentile
1730,31159,Nebraska,Seward,331,309,36,-22,-58,2.63636363636364,Top 25th percentile
1731,31185,Nebraska,York,299,281,20,-18,-38,2.11111111111111,Top 25th percentile
1732,32005,Nevada,Douglas,911,1070,86,159,73,0.459119496855346,Top 25th percentile
1733,32510,Nevada,Carson City (city),1386,1633,158,247,89,0.360323886639676,50th-75th percentile
1734,32003,Nevada,Clark,31227,37084,5736,5857,121,0.0206590404644016,25th-50th percentile
1735,32023,Nevada,Nye,1440,1696,208,256,48,0.1875,25th-50th percentile
1736,32001,Nevada,Churchill,496,626,79,130,51,0.392307692307692,50th-75th percentile
1737,32009,Nevada,Esmeralda,22,18,14,-4,-18,4.5,Top 25th percentile
1738,32019,Nevada,Lyon,1133,1433,138,300,162,0.54,Top 25th percentile
1739,32021,Nevada,Mineral,131,152,8,21,13,0.619047619047619,Top 25th percentile
1740,32029,Nevada,Storey,69,73,6,4,-2,-0.5,Bottom 25th percentile
1741,32007,Nevada,Elko,537,736,125,199,74,0.371859296482412,50th-75th percentile
1742,32011,Nevada,Eureka,28,32,7,4,-3,-0.75,Bottom 25th percentile
1743,32013,Nevada,Humboldt,222,275,38,53,15,0.283018867924528,50th-75th percentile
1744,32015,Nevada,Lander,82,115,15,33,18,0.545454545454545,Top 25th percentile
1745,32017,Nevada,Lincoln,89,100,4,11,7,0.636363636363636,Top 25th percentile
1746,32027,Nevada,Pershing,91,113,28,22,-6,-0.272727272727273,Bottom 25th percentile
1747,32033,Nevada,White Pine,154,159,11,5,-6,-1.2,Bottom 25th percentile
1748,32031,Nevada,Washoe,6838,7877,860,1039,179,0.17228103946102,25th-50th percentile
1749,33001,New Hampshire,Belknap,1292,1383,108,91,-17,-0.186813186813187,Bottom 25th percentile
1750,33003,New Hampshire,Carroll,988,997,20,9,-11,-1.22222222222222,Bottom 25th percentile
1751,33005,New Hampshire,Cheshire,1302,1409,52,107,55,0.514018691588785,Top 25th percentile
1752,33007,New Hampshire,Coos,778,841,55,63,8,0.126984126984127,25th-50th percentile
1753,33009,New Hampshire,Grafton,1512,1512,36,0,-36,-inf,Bottom 25th percentile
1754,33011,New Hampshire,Hillsborough,5925,6682,615,757,142,0.187582562747688,25th-50th percentile
1755,33013,New Hampshire,Merrimack,2469,2577,113,108,-5,-0.0462962962962963,Bottom 25th percentile
1756,33019,New Hampshire,Sullivan,801,816,31,15,-16,-1.06666666666667,Bottom 25th percentile
1757,33015,New Hampshire,Rockingham,4454,4890,325,436,111,0.254587155963303,50th-75th percentile
1758,33017,New Hampshire,Strafford,2005,2122,97,117,20,0.170940170940171,25th-50th percentile
1759,34001,New Jersey,Atlantic,4675,5683,648,1008,360,0.357142857142857,50th-75th percentile
1760,34003,New Jersey,Bergen,12984,14875,2513,1891,-622,-0.328926493918562,Bottom 25th percentile
1761,34005,New Jersey,Burlington,7193,8000,808,807,-1,-0.0012391573729863,25th-50th percentile
1762,34007,New Jersey,Camden,8327,9766,1147,1439,292,0.202918693537179,25th-50th percentile
1763,34009,New Jersey,Cape May,2244,2469,201,225,24,0.106666666666667,25th-50th percentile
1764,34011,New Jersey,Cumberland,2630,3219,378,589,211,0.358234295415959,50th-75th percentile
1765,34013,New Jersey,Essex,10321,13424,2695,3103,408,0.131485659039639,25th-50th percentile
1766,34015,New Jersey,Gloucester,4710,5552,599,842,243,0.288598574821853,50th-75th percentile
1767,34017,New Jersey,Hudson,6633,9026,2083,2393,310,0.129544504805683,25th-50th percentile
1768,34019,New Jersey,Hunterdon,1603,1816,197,213,16,0.0751173708920188,25th-50th percentile
1769,34021,New Jersey,Mercer,5081,6118,847,1037,190,0.183220829315333,25th-50th percentile
1770,34023,New Jersey,Middlesex,10524,12716,2099,2192,93,0.0424270072992701,25th-50th percentile
1771,34025,New Jersey,Monmouth,9811,11618,1513,1807,294,0.162700608743774,25th-50th percentile
1772,34027,New Jersey,Morris,6898,8053,1100,1155,55,0.0476190476190476,25th-50th percentile
1773,34029,New Jersey,Ocean,13210,14781,1914,1571,-343,-0.218332272437938,Bottom 25th percentile
1774,34031,New Jersey,Passaic,6562,8405,1804,1843,39,0.0211611502984265,25th-50th percentile
1775,34033,New Jersey,Salem,1265,1563,179,298,119,0.399328859060403,50th-75th percentile
1776,34035,New Jersey,Somerset,4310,5000,700,690,-10,-0.0144927536231884,25th-50th percentile
1777,34037,New Jersey,Sussex,2170,2630,311,460,149,0.323913043478261,50th-75th percentile
1778,34039,New Jersey,Union,7047,8895,1806,1848,42,0.0227272727272727,25th-50th percentile
1779,34041,New Jersey,Warren,1802,2060,231,258,27,0.104651162790698,25th-50th percentile
1780,35001,New Mexico,Bernalillo,9635,11433,1031,1798,767,0.426585094549499,Top 25th percentile
1781,35003,New Mexico,Catron,75,90,9,15,6,0.4,50th-75th percentile
1782,35006,New Mexico,Cibola,425,622,129,197,68,0.345177664974619,50th-75th percentile
1783,35051,New Mexico,Sierra,423,486,55,63,8,0.126984126984127,25th-50th percentile
1784,35053,New Mexico,Socorro,300,355,64,55,-9,-0.163636363636364,Bottom 25th percentile
1785,35005,New Mexico,Chaves,1128,1384,203,256,53,0.20703125,25th-50th percentile
1786,35009,New Mexico,Curry,695,823,125,128,3,0.0234375,25th-50th percentile
1787,35041,New Mexico,Roosevelt,291,324,66,33,-33,-1.0,Bottom 25th percentile
1788,35013,New Mexico,Do�a Ana,2810,3800,504,990,486,0.490909090909091,Top 25th percentile
1789,35015,New Mexico,Eddy,977,1147,191,170,-21,-0.123529411764706,Bottom 25th percentile
1790,35017,New Mexico,Grant,584,709,58,125,67,0.536,Top 25th percentile
1791,35023,New Mexico,Hidalgo,89,106,13,17,4,0.235294117647059,25th-50th percentile
1792,35029,New Mexico,Luna,532,674,98,142,44,0.309859154929577,50th-75th percentile
1793,35011,New Mexico,De Baca,43,66,13,23,10,0.434782608695652,Top 25th percentile
1794,35019,New Mexico,Guadalupe,80,104,9,24,15,0.625,Top 25th percentile
1795,35027,New Mexico,Lincoln,403,449,46,46,0,0.0,25th-50th percentile
1796,35037,New Mexico,Quay,202,252,27,50,23,0.46,Top 25th percentile
1797,35057,New Mexico,Torrance,261,335,25,74,49,0.662162162162162,Top 25th percentile
1798,35025,New Mexico,Lea,956,1189,274,233,-41,-0.175965665236052,Bottom 25th percentile
1799,35028,New Mexico,Los Alamos,235,227,10,-8,-18,2.25,Top 25th percentile
1800,35049,New Mexico,Santa Fe,2063,2457,173,394,221,0.560913705583756,Top 25th percentile
1801,35031,New Mexico,McKinley,1031,1833,518,802,284,0.354114713216958,50th-75th percentile
1802,35007,New Mexico,Colfax,239,283,48,44,-4,-0.0909090909090909,Bottom 25th percentile
1803,35021,New Mexico,Harding,19,25,7,6,-1,-0.166666666666667,Bottom 25th percentile
1804,35033,New Mexico,Mora,77,83,12,6,-6,-1.0,Bottom 25th percentile
1805,35047,New Mexico,San Miguel,477,531,37,54,17,0.314814814814815,50th-75th percentile
1806,35059,New Mexico,Union,78,97,9,19,10,0.526315789473684,Top 25th percentile
1807,35035,New Mexico,Otero,1068,1333,115,265,150,0.566037735849057,Top 25th percentile
1808,35039,New Mexico,Rio Arriba,656,846,83,190,107,0.563157894736842,Top 25th percentile
1809,35055,New Mexico,Taos,522,672,70,150,80,0.533333333333333,Top 25th percentile
1810,35043,New Mexico,Sandoval,2044,2381,263,337,74,0.219584569732938,25th-50th percentile
1811,35045,New Mexico,San Juan,1742,2564,562,822,260,0.316301703163017,50th-75th percentile
1812,35061,New Mexico,Valencia,1204,1419,149,215,66,0.306976744186047,50th-75th percentile
1813,36001,New York,Albany,4868,5423,416,555,139,0.25045045045045,50th-75th percentile
1814,36039,New York,Greene,911,1014,80,103,23,0.223300970873786,25th-50th percentile
1815,36003,New York,Allegany,861,921,106,60,-46,-0.766666666666667,Bottom 25th percentile
1816,36101,New York,Steuben,1807,2017,214,210,-4,-0.0190476190476191,25th-50th percentile
1817,36005,New York,Bronx,16910,23960,5605,7050,1445,0.204964539007092,25th-50th percentile
1818,36007,New York,Broome,3678,4165,449,487,38,0.0780287474332649,25th-50th percentile
1819,36009,New York,Cattaraugus,1489,1762,148,273,125,0.457875457875458,Top 25th percentile
1820,36121,New York,Wyoming,660,765,66,105,39,0.371428571428571,50th-75th percentile
1821,36011,New York,Cayuga,1340,1587,125,247,122,0.493927125506073,Top 25th percentile
1822,36013,New York,Chautauqua,2628,2889,248,261,13,0.0498084291187739,25th-50th percentile
1823,36015,New York,Chemung,1761,1917,181,156,-25,-0.16025641025641,Bottom 25th percentile
1824,36017,New York,Chenango,1025,1115,100,90,-10,-0.111111111111111,Bottom 25th percentile
1825,36023,New York,Cortland,783,931,75,148,73,0.493243243243243,Top 25th percentile
1826,36019,New York,Clinton,1302,1429,49,127,78,0.614173228346457,Top 25th percentile
1827,36021,New York,Columbia,1182,1267,96,85,-11,-0.129411764705882,Bottom 25th percentile
1828,36025,New York,Delaware,939,1070,77,131,54,0.412213740458015,50th-75th percentile
1829,36095,New York,Schoharie,538,577,29,39,10,0.256410256410256,50th-75th percentile
1830,36027,New York,Dutchess,4455,5137,560,682,122,0.178885630498534,25th-50th percentile
1831,36029,New York,Erie,17079,18782,2064,1703,-361,-0.211978860833823,Bottom 25th percentile
1832,36031,New York,Essex,763,818,20,55,35,0.636363636363636,Top 25th percentile
1833,36033,New York,Franklin,834,871,31,37,6,0.162162162162162,25th-50th percentile
1834,36035,New York,Fulton,1075,1272,130,197,67,0.34010152284264,50th-75th percentile
1835,36041,New York,Hamilton,108,133,6,25,19,0.76,Top 25th percentile
1836,36037,New York,Genesee,1093,1232,147,139,-8,-0.0575539568345324,Bottom 25th percentile
1837,36073,New York,Orleans,742,854,80,112,32,0.285714285714286,50th-75th percentile
1838,36043,New York,Herkimer,1189,1325,145,136,-9,-0.0661764705882353,Bottom 25th percentile
1839,36045,New York,Jefferson,1569,1688,98,119,21,0.176470588235294,25th-50th percentile
1840,36049,New York,Lewis,453,456,38,3,-35,-11.6666666666667,Bottom 25th percentile
1841,36047,New York,Kings,28089,38612,9127,10523,1396,0.132661788463366,25th-50th percentile
1842,36051,New York,Livingston,1010,1056,80,46,-34,-0.739130434782609,Bottom 25th percentile
1843,36053,New York,Madison,1044,1239,124,195,71,0.364102564102564,50th-75th percentile
1844,36055,New York,Monroe,11625,13443,1382,1818,436,0.23982398239824,25th-50th percentile
1845,36057,New York,Montgomery,1026,1200,121,174,53,0.304597701149425,50th-75th percentile
1846,36059,New York,Nassau,19499,23246,3927,3747,-180,-0.0480384307445957,Bottom 25th percentile
1847,36061,New York,New York (county),17636,22027,3837,4391,554,0.126167160100205,25th-50th percentile
1848,36063,New York,Niagara,4196,4895,503,699,196,0.280400572246066,50th-75th percentile
1849,36065,New York,Oneida,4510,5075,610,565,-45,-0.079646017699115,Bottom 25th percentile
1850,36067,New York,Onondaga,7527,8732,872,1205,333,0.276348547717842,50th-75th percentile
1851,36069,New York,Ontario,1922,1985,143,63,-80,-1.26984126984127,Bottom 25th percentile
1852,36071,New York,Orange,4836,5711,927,875,-52,-0.0594285714285714,Bottom 25th percentile
1853,36075,New York,Oswego,1912,2080,152,168,16,0.0952380952380952,25th-50th percentile
1854,36077,New York,Otsego,1081,1225,81,144,63,0.4375,Top 25th percentile
1855,36079,New York,Putnam,1256,1436,161,180,19,0.105555555555556,25th-50th percentile
1856,36081,New York,Queens,25525,35700,8857,10175,1318,0.12953316953317,25th-50th percentile
1857,36083,New York,Rensselaer,2616,2934,197,318,121,0.380503144654088,50th-75th percentile
1858,36085,New York,Richmond,6634,8219,1655,1585,-70,-0.0441640378548896,25th-50th percentile
1859,36087,New York,Rockland,3999,4991,1061,992,-69,-0.0695564516129032,Bottom 25th percentile
1860,36089,New York,St. Lawrence,1786,1978,137,192,55,0.286458333333333,50th-75th percentile
1861,36091,New York,Saratoga,3447,3800,254,353,99,0.280453257790368,50th-75th percentile
1862,36093,New York,Schenectady,2772,3083,234,311,77,0.247588424437299,50th-75th percentile
1863,36097,New York,Schuyler,369,405,19,36,17,0.472222222222222,Top 25th percentile
1864,36099,New York,Seneca,643,677,61,34,-27,-0.794117647058824,Bottom 25th percentile
1865,36123,New York,Yates,482,517,32,35,3,0.0857142857142857,25th-50th percentile
1866,36103,New York,Suffolk,21640,25981,4349,4341,-8,-0.0018428933425478,25th-50th percentile
1867,36105,New York,Sullivan,1260,1452,121,192,71,0.369791666666667,50th-75th percentile
1868,36107,New York,Tioga,827,974,95,147,52,0.353741496598639,50th-75th percentile
1869,36109,New York,Tompkins,1203,1221,63,18,-45,-2.5,Bottom 25th percentile
1870,36111,New York,Ulster,3034,3391,321,357,36,0.100840336134454,25th-50th percentile
1871,36113,New York,Warren,1304,1437,84,133,49,0.368421052631579,50th-75th percentile
1872,36115,New York,Washington,1156,1308,80,152,72,0.473684210526316,Top 25th percentile
1873,36117,New York,Wayne,1559,1673,112,114,2,0.0175438596491228,25th-50th percentile
1874,36119,New York,Westchester,12836,15560,2793,2724,-69,-0.0253303964757709,25th-50th percentile
1875,37001,North Carolina,Alamance,3075,3397,308,322,14,0.0434782608695652,25th-50th percentile
1876,37003,North Carolina,Alexander,705,955,132,250,118,0.472,Top 25th percentile
1877,37035,North Carolina,Catawba,2985,3497,449,512,63,0.123046875,25th-50th percentile
1878,37005,North Carolina,Alleghany,253,255,11,2,-9,-4.5,Bottom 25th percentile
1879,37009,North Carolina,Ashe,608,712,77,104,27,0.259615384615385,50th-75th percentile
1880,37011,North Carolina,Avery,386,428,47,42,-5,-0.119047619047619,Bottom 25th percentile
1881,37189,North Carolina,Watauga,652,694,52,42,-10,-0.238095238095238,Bottom 25th percentile
1882,37007,North Carolina,Anson,524,620,102,96,-6,-0.0625,Bottom 25th percentile
1883,37153,North Carolina,Richmond,968,1117,145,149,4,0.0268456375838926,25th-50th percentile
1884,37013,North Carolina,Beaufort,1033,1132,137,99,-38,-0.383838383838384,Bottom 25th percentile
1885,37117,North Carolina,Martin,527,672,78,145,67,0.462068965517241,Top 25th percentile
1886,37137,North Carolina,Pamlico,323,331,22,8,-14,-1.75,Bottom 25th percentile
1887,37017,North Carolina,Bladen,708,874,112,166,54,0.325301204819277,50th-75th percentile
1888,37047,North Carolina,Columbus,1204,1487,225,283,58,0.204946996466431,25th-50th percentile
1889,37019,North Carolina,Brunswick,2877,3137,269,260,-9,-0.0346153846153846,25th-50th percentile
1890,37021,North Carolina,Buncombe,4726,5114,398,388,-10,-0.0257731958762887,25th-50th percentile
1891,37115,North Carolina,Madison,462,477,47,15,-32,-2.13333333333333,Bottom 25th percentile
1892,37023,North Carolina,Burke,1797,2006,244,209,-35,-0.167464114832536,Bottom 25th percentile
1893,37025,North Carolina,Cabarrus,2892,3136,353,244,-109,-0.44672131147541,Bottom 25th percentile
1894,37027,North Carolina,Caldwell,1721,1996,261,275,14,0.0509090909090909,25th-50th percentile
1895,37029,North Carolina,Camden,155,183,8,28,20,0.714285714285714,Top 25th percentile
1896,37053,North Carolina,Currituck,426,507,33,81,48,0.592592592592593,Top 25th percentile
1897,37139,North Carolina,Pasquotank,758,881,90,123,33,0.268292682926829,50th-75th percentile
1898,37031,North Carolina,Carteret,1484,1599,99,115,16,0.139130434782609,25th-50th percentile
1899,37033,North Carolina,Caswell,473,593,55,120,65,0.541666666666667,Top 25th percentile
1900,37145,North Carolina,Person,797,912,97,115,18,0.156521739130435,25th-50th percentile
1901,37037,North Carolina,Chatham,1306,1391,98,85,-13,-0.152941176470588,Bottom 25th percentile
1902,37039,North Carolina,Cherokee,704,832,116,128,12,0.09375,25th-50th percentile
1903,37043,North Carolina,Clay,285,269,45,-16,-61,3.8125,Top 25th percentile
1904,37075,North Carolina,Graham,186,217,25,31,6,0.193548387096774,25th-50th percentile
1905,37173,North Carolina,Swain,355,411,36,56,20,0.357142857142857,50th-75th percentile
1906,37045,North Carolina,Cleveland,2168,2509,364,341,-23,-0.0674486803519062,Bottom 25th percentile
1907,37049,North Carolina,Craven,1884,2181,195,297,102,0.343434343434343,50th-75th percentile
1908,37051,North Carolina,Cumberland,4470,5307,547,837,290,0.34647550776583,50th-75th percentile
1909,37055,North Carolina,Dare,640,638,24,-2,-26,13.0,Top 25th percentile
1910,37095,North Carolina,Hyde,108,93,8,-15,-23,1.53333333333333,Top 25th percentile
1911,37177,North Carolina,Tyrrell,73,79,7,6,-1,-0.166666666666667,Bottom 25th percentile
1912,37187,North Carolina,Washington,297,322,41,25,-16,-0.64,Bottom 25th percentile
1913,37057,North Carolina,Davidson,3242,3749,429,507,78,0.153846153846154,25th-50th percentile
1914,37059,North Carolina,Davie,841,907,108,66,-42,-0.636363636363636,Bottom 25th percentile
1915,37197,North Carolina,Yadkin,770,813,94,43,-51,-1.18604651162791,Bottom 25th percentile
1916,37061,North Carolina,Duplin,938,1200,174,262,88,0.33587786259542,50th-75th percentile
1917,37063,North Carolina,Durham,3706,3769,258,63,-195,-3.0952380952381,Bottom 25th percentile
1918,37065,North Carolina,Edgecombe,1149,1257,143,108,-35,-0.324074074074074,Bottom 25th percentile
1919,37067,North Carolina,Forsyth,6081,6603,594,522,-72,-0.137931034482759,Bottom 25th percentile
1920,37169,North Carolina,Stokes,971,1074,96,103,7,0.0679611650485437,25th-50th percentile
1921,37069,North Carolina,Franklin,1120,1170,106,50,-56,-1.12,Bottom 25th percentile
1922,37185,North Carolina,Warren,441,483,40,42,2,0.0476190476190476,25th-50th percentile
1923,37071,North Carolina,Gaston,4262,4802,623,540,-83,-0.153703703703704,Bottom 25th percentile
1924,37015,North Carolina,Bertie,432,517,65,85,20,0.235294117647059,25th-50th percentile
1925,37041,North Carolina,Chowan,359,398,38,39,1,0.0256410256410256,25th-50th percentile
1926,37073,North Carolina,Gates,230,263,35,33,-2,-0.0606060606060606,Bottom 25th percentile
1927,37091,North Carolina,Hertford,477,572,76,95,19,0.2,25th-50th percentile
1928,37143,North Carolina,Perquimans,339,356,38,17,-21,-1.23529411764706,Bottom 25th percentile
1929,37077,North Carolina,Granville,976,1161,105,185,80,0.432432432432432,Top 25th percentile
1930,37181,North Carolina,Vance,906,1064,127,158,31,0.19620253164557,25th-50th percentile
1931,37079,North Carolina,Greene,361,418,47,57,10,0.175438596491228,25th-50th percentile
1932,37103,North Carolina,Jones,204,284,31,80,49,0.6125,Top 25th percentile
1933,37107,North Carolina,Lenoir,1245,1473,174,228,54,0.236842105263158,25th-50th percentile
1934,37081,North Carolina,Guilford,7941,8972,822,1031,209,0.202715809893307,25th-50th percentile
1935,37083,North Carolina,Halifax,1120,1401,141,281,140,0.498220640569395,Top 25th percentile
1936,37131,North Carolina,Northampton,453,571,85,118,33,0.279661016949153,50th-75th percentile
1937,37085,North Carolina,Harnett,1786,2120,263,334,71,0.212574850299401,25th-50th percentile
1938,37087,North Carolina,Haywood,1412,1613,162,201,39,0.194029850746269,25th-50th percentile
1939,37089,North Carolina,Henderson,2502,2614,219,112,-107,-0.955357142857143,Bottom 25th percentile
1940,37093,North Carolina,Hoke,636,784,109,148,39,0.263513513513514,50th-75th percentile
1941,37165,North Carolina,Scotland,700,922,123,222,99,0.445945945945946,Top 25th percentile
1942,37097,North Carolina,Iredell,2868,3183,375,315,-60,-0.19047619047619,Bottom 25th percentile
1943,37099,North Carolina,Jackson,691,699,71,8,-63,-7.875,Bottom 25th percentile
1944,37113,North Carolina,Macon,829,954,84,125,41,0.328,50th-75th percentile
1945,37175,North Carolina,Transylvania,747,794,55,47,-8,-0.170212765957447,Bottom 25th percentile
1946,37101,North Carolina,Johnston,2842,3158,347,316,-31,-0.0981012658227848,Bottom 25th percentile
1947,37105,North Carolina,Lee,1058,1198,115,140,25,0.178571428571429,25th-50th percentile
1948,37109,North Carolina,Lincoln,1510,1670,225,160,-65,-0.40625,Bottom 25th percentile
1949,37111,North Carolina,McDowell,943,1084,165,141,-24,-0.170212765957447,Bottom 25th percentile
1950,37121,North Carolina,Mitchell,407,413,56,6,-50,-8.33333333333333,Bottom 25th percentile
1951,37199,North Carolina,Yancey,416,468,59,52,-7,-0.134615384615385,Bottom 25th percentile
1952,37119,North Carolina,Mecklenburg,11340,12961,1359,1621,262,0.161628624305984,25th-50th percentile
1953,37123,North Carolina,Montgomery,545,638,99,93,-6,-0.0645161290322581,Bottom 25th percentile
1954,37125,North Carolina,Moore,2119,2281,232,162,-70,-0.432098765432099,Bottom 25th percentile
1955,37127,North Carolina,Nash,1914,2076,231,162,-69,-0.425925925925926,Bottom 25th percentile
1956,37129,North Carolina,New Hanover,3525,3930,284,405,121,0.298765432098765,50th-75th percentile
1957,37133,North Carolina,Onslow,2141,2461,279,320,41,0.128125,25th-50th percentile
1958,37135,North Carolina,Orange,1464,1534,100,70,-30,-0.428571428571429,Bottom 25th percentile
1959,37141,North Carolina,Pender,1081,1233,111,152,41,0.269736842105263,50th-75th percentile
1960,37147,North Carolina,Pitt,2300,2723,289,423,134,0.316784869976359,50th-75th percentile
1961,37149,North Carolina,Polk,538,570,68,32,-36,-1.125,Bottom 25th percentile
1962,37161,North Carolina,Rutherford,1506,1823,305,317,12,0.0378548895899054,25th-50th percentile
1963,37151,North Carolina,Randolph,2715,3165,388,450,62,0.137777777777778,25th-50th percentile
1964,37155,North Carolina,Robeson,2354,2949,460,595,135,0.226890756302521,25th-50th percentile
1965,37157,North Carolina,Rockingham,2039,2399,248,360,112,0.311111111111111,50th-75th percentile
1966,37159,North Carolina,Rowan,2845,3302,456,457,1,0.0021881838074398,25th-50th percentile
1967,37163,North Carolina,Sampson,1204,1319,154,115,-39,-0.339130434782609,Bottom 25th percentile
1968,37167,North Carolina,Stanly,1272,1440,192,168,-24,-0.142857142857143,Bottom 25th percentile
1969,37171,North Carolina,Surry,1645,1775,228,130,-98,-0.753846153846154,Bottom 25th percentile
1970,37179,North Carolina,Union,2733,3026,371,293,-78,-0.266211604095563,Bottom 25th percentile
1971,37183,North Carolina,Wake,10557,11136,908,579,-329,-0.568221070811744,Bottom 25th percentile
1972,37191,North Carolina,Wayne,2249,2534,322,285,-37,-0.129824561403509,Bottom 25th percentile
1973,37193,North Carolina,Wilkes,1440,1669,210,229,19,0.0829694323144105,25th-50th percentile
1974,37195,North Carolina,Wilson,1585,1909,231,324,93,0.287037037037037,50th-75th percentile
1975,38005,North Dakota,Benson,109,150,19,41,22,0.536585365853659,Top 25th percentile
1976,38027,North Dakota,Eddy,72,76,9,4,-5,-1.25,Bottom 25th percentile
1977,38031,North Dakota,Foster,73,88,24,15,-9,-0.6,Bottom 25th percentile
1978,38039,North Dakota,Griggs,67,58,6,-9,-15,1.66666666666667,Top 25th percentile
1979,38069,North Dakota,Pierce,89,107,25,18,-7,-0.388888888888889,Bottom 25th percentile
1980,38071,North Dakota,Ramsey,240,258,25,18,-7,-0.388888888888889,Bottom 25th percentile
1981,38079,North Dakota,Rolette,221,297,31,76,45,0.592105263157895,Top 25th percentile
1982,38095,North Dakota,Towner,46,57,8,11,3,0.272727272727273,50th-75th percentile
1983,38103,North Dakota,Wells,110,111,11,1,-10,-10.0,Bottom 25th percentile
1984,38017,North Dakota,Cass,2062,2309,224,247,23,0.0931174089068826,25th-50th percentile
1985,38003,North Dakota,Barnes,223,285,30,62,32,0.516129032258065,Top 25th percentile
1986,38021,North Dakota,Dickey,120,137,40,17,-23,-1.35294117647059,Bottom 25th percentile
1987,38045,North Dakota,LaMoure,74,79,16,5,-11,-2.2,Bottom 25th percentile
1988,38073,North Dakota,Ransom,135,138,9,3,-6,-2.0,Bottom 25th percentile
1989,38077,North Dakota,Richland,257,246,23,-11,-34,3.09090909090909,Top 25th percentile
1990,38081,North Dakota,Sargent,63,80,9,17,8,0.470588235294118,Top 25th percentile
1991,38093,North Dakota,Stutsman,409,456,77,47,-30,-0.638297872340426,Bottom 25th percentile
1992,38009,North Dakota,Bottineau,143,124,25,-19,-44,2.31578947368421,Top 25th percentile
1993,38049,North Dakota,McHenry,110,139,15,29,14,0.482758620689655,Top 25th percentile
1994,38055,North Dakota,McLean,193,204,26,11,-15,-1.36363636363636,Bottom 25th percentile
1995,38075,North Dakota,Renville,49,61,16,12,-4,-0.333333333333333,Bottom 25th percentile
1996,38083,North Dakota,Sheridan,21,27,6,6,0,0.0,25th-50th percentile
1997,38101,North Dakota,Ward,829,1088,194,259,65,0.250965250965251,50th-75th percentile
1998,38019,North Dakota,Cavalier,82,92,7,10,3,0.3,50th-75th percentile
1999,38035,North Dakota,Grand Forks,893,951,89,58,-31,-0.53448275862069,Bottom 25th percentile
2000,38063,North Dakota,Nelson,95,94,17,-1,-18,18.0,Top 25th percentile
2001,38067,North Dakota,Pembina,137,151,15,14,-1,-0.0714285714285714,Bottom 25th percentile
2002,38091,North Dakota,Steele,31,37,6,6,0,0.0,25th-50th percentile
2003,38097,North Dakota,Traill,166,181,16,15,-1,-0.0666666666666667,Bottom 25th percentile
2004,38099,North Dakota,Walsh,252,242,30,-10,-40,4.0,Top 25th percentile
2005,38007,North Dakota,Billings,20,7,7,-13,-20,1.53846153846154,Top 25th percentile
2006,38013,North Dakota,Burke,32,37,8,5,-3,-0.6,Bottom 25th percentile
2007,38023,North Dakota,Divide,51,44,7,-7,-14,2.0,Top 25th percentile
2008,38025,North Dakota,Dunn,58,68,9,10,1,0.1,25th-50th percentile
2009,38033,North Dakota,Golden Valley,24,31,4,7,3,0.428571428571429,Top 25th percentile
2010,38053,North Dakota,McKenzie,128,152,23,24,1,0.0416666666666667,25th-50th percentile
2011,38061,North Dakota,Mountrail,155,175,28,20,-8,-0.4,Bottom 25th percentile
2012,38089,North Dakota,Stark,419,466,65,47,-18,-0.382978723404255,Bottom 25th percentile
2013,38105,North Dakota,Williams,434,390,47,-44,-91,2.06818181818182,Top 25th percentile
2014,38015,North Dakota,Burleigh,1344,1611,220,267,47,0.176029962546816,25th-50th percentile
2015,38029,North Dakota,Emmons,78,94,18,16,-2,-0.125,Bottom 25th percentile
2016,38043,North Dakota,Kidder,38,55,9,17,8,0.470588235294118,Top 25th percentile
2017,38047,North Dakota,Logan,44,48,6,4,-2,-0.5,Bottom 25th percentile
2018,38051,North Dakota,McIntosh,79,95,7,16,9,0.5625,Top 25th percentile
2019,38001,North Dakota,Adams,57,56,5,-1,-6,6.0,Top 25th percentile
2020,38011,North Dakota,Bowman,61,73,11,12,1,0.0833333333333333,25th-50th percentile
2021,38037,North Dakota,Grant,57,70,9,13,4,0.307692307692308,50th-75th percentile
2022,38041,North Dakota,Hettinger,51,61,14,10,-4,-0.4,Bottom 25th percentile
2023,38057,North Dakota,Mercer,133,124,13,-9,-22,2.44444444444444,Top 25th percentile
2024,38059,North Dakota,Morton,550,648,85,98,13,0.13265306122449,25th-50th percentile
2025,38065,North Dakota,Oliver,24,25,7,1,-6,-6.0,Bottom 25th percentile
2026,38085,North Dakota,Sioux,64,89,8,25,17,0.68,Top 25th percentile
2027,38087,North Dakota,Slope,19,6,6,-13,-19,1.46153846153846,Top 25th percentile
2028,39001,Ohio,Adams,621,770,108,149,41,0.275167785234899,50th-75th percentile
2029,39015,Ohio,Brown,918,1103,107,185,78,0.421621621621622,Top 25th percentile
2030,39003,Ohio,Allen,2008,2229,310,221,-89,-0.402714932126697,Bottom 25th percentile
2031,39005,Ohio,Ashland,1040,1201,144,161,17,0.105590062111801,25th-50th percentile
2032,39007,Ohio,Ashtabula,2095,2323,224,228,4,0.0175438596491228,25th-50th percentile
2033,39009,Ohio,Athens,897,1015,90,118,28,0.23728813559322,25th-50th percentile
2034,39073,Ohio,Hocking,555,699,94,144,50,0.347222222222222,50th-75th percentile
2035,39011,Ohio,Auglaize,866,1029,113,163,50,0.306748466257669,50th-75th percentile
2036,39107,Ohio,Mercer,727,867,95,140,45,0.321428571428571,50th-75th percentile
2037,39013,Ohio,Belmont,1527,1827,236,300,64,0.213333333333333,25th-50th percentile
2038,39017,Ohio,Butler,5907,6979,780,1072,292,0.272388059701493,50th-75th percentile
2039,39019,Ohio,Carroll,572,672,80,100,20,0.2,25th-50th percentile
2040,39067,Ohio,Harrison,368,432,51,64,13,0.203125,25th-50th percentile
2041,39157,Ohio,Tuscarawas,1956,2277,357,321,-36,-0.11214953271028,Bottom 25th percentile
2042,39021,Ohio,Champaign,714,825,82,111,29,0.261261261261261,50th-75th percentile
2043,39091,Ohio,Logan,867,991,106,124,18,0.145161290322581,25th-50th percentile
2044,39097,Ohio,Madison,742,857,88,115,27,0.234782608695652,25th-50th percentile
2045,39149,Ohio,Shelby,801,1033,130,232,102,0.439655172413793,Top 25th percentile
2046,39023,Ohio,Clark,2973,3510,379,537,158,0.294227188081937,50th-75th percentile
2047,39025,Ohio,Clermont,3209,3895,349,686,337,0.491253644314869,Top 25th percentile
2048,39027,Ohio,Clinton,780,934,109,154,45,0.292207792207792,50th-75th percentile
2049,39047,Ohio,Fayette,651,689,70,38,-32,-0.842105263157895,Bottom 25th percentile
2050,39071,Ohio,Highland,876,1010,113,134,21,0.156716417910448,25th-50th percentile
2051,39029,Ohio,Columbiana,2258,2620,318,362,44,0.121546961325967,25th-50th percentile
2052,39031,Ohio,Coshocton,750,869,100,119,19,0.159663865546218,25th-50th percentile
2053,39075,Ohio,Holmes,624,724,126,100,-26,-0.26,Bottom 25th percentile
2054,39033,Ohio,Crawford,999,1217,143,218,75,0.344036697247706,50th-75th percentile
2055,39139,Ohio,Richland,2574,2914,324,340,16,0.0470588235294118,25th-50th percentile
2056,39035,Ohio,Cuyahoga,23528,26607,2617,3079,462,0.150048717115947,25th-50th percentile
2057,39037,Ohio,Darke,1088,1201,179,113,-66,-0.584070796460177,Bottom 25th percentile
2058,39135,Ohio,Preble,832,1002,135,170,35,0.205882352941176,25th-50th percentile
2059,39039,Ohio,Defiance,718,805,111,87,-24,-0.275862068965517,Bottom 25th percentile
2060,39171,Ohio,Williams,743,776,96,33,-63,-1.90909090909091,Bottom 25th percentile
2061,39041,Ohio,Delaware,2146,2521,190,375,185,0.493333333333333,Top 25th percentile
2062,39043,Ohio,Erie,1665,1968,198,303,105,0.346534653465347,50th-75th percentile
2063,39045,Ohio,Fairfield,2502,2872,292,370,78,0.210810810810811,25th-50th percentile
2064,39049,Ohio,Franklin,17198,18966,1787,1768,-19,-0.0107466063348416,25th-50th percentile
2065,39051,Ohio,Fulton,767,867,107,100,-7,-0.07,Bottom 25th percentile
2066,39069,Ohio,Henry,513,621,77,108,31,0.287037037037037,50th-75th percentile
2067,39053,Ohio,Gallia,662,728,77,66,-11,-0.166666666666667,Bottom 25th percentile
2068,39105,Ohio,Meigs,514,609,58,95,37,0.389473684210526,50th-75th percentile
2069,39055,Ohio,Geauga,1482,1766,173,284,111,0.390845070422535,50th-75th percentile
2070,39057,Ohio,Greene,2728,3211,363,483,120,0.248447204968944,50th-75th percentile
2071,39059,Ohio,Guernsey,845,995,83,150,67,0.446666666666667,Top 25th percentile
2072,39111,Ohio,Monroe,316,380,58,64,6,0.09375,25th-50th percentile
2073,39121,Ohio,Noble,250,276,46,26,-20,-0.769230769230769,Bottom 25th percentile
2074,39061,Ohio,Hamilton,13748,15403,1518,1655,137,0.0827794561933535,25th-50th percentile
2075,39063,Ohio,Hancock,1371,1543,168,172,4,0.0232558139534884,25th-50th percentile
2076,39065,Ohio,Hardin,558,729,97,171,74,0.432748538011696,Top 25th percentile
2077,39175,Ohio,Wyandot,447,523,68,76,8,0.105263157894737,25th-50th percentile
2078,39077,Ohio,Huron,1060,1243,153,183,30,0.163934426229508,25th-50th percentile
2079,39079,Ohio,Jackson,758,832,93,74,-19,-0.256756756756757,Bottom 25th percentile
2080,39131,Ohio,Pike,642,755,75,113,38,0.336283185840708,50th-75th percentile
2081,39163,Ohio,Vinton,289,345,31,56,25,0.446428571428571,Top 25th percentile
2082,39081,Ohio,Jefferson,1606,1844,221,238,17,0.0714285714285714,25th-50th percentile
2083,39083,Ohio,Knox,1084,1374,166,290,124,0.427586206896552,Top 25th percentile
2084,39117,Ohio,Morrow,562,660,64,98,34,0.346938775510204,50th-75th percentile
2085,39085,Ohio,Lake,4384,5005,478,621,143,0.230273752012882,25th-50th percentile
2086,39087,Ohio,Lawrence,1459,1693,172,234,62,0.264957264957265,50th-75th percentile
2087,39089,Ohio,Licking,3004,3415,319,411,92,0.223844282238443,25th-50th percentile
2088,39093,Ohio,Lorain,5553,6348,626,795,169,0.212578616352201,25th-50th percentile
2089,39095,Ohio,Lucas,7860,9215,1010,1355,345,0.254612546125461,50th-75th percentile
2090,39123,Ohio,Ottawa,892,1039,99,147,48,0.326530612244898,50th-75th percentile
2091,39099,Ohio,Mahoning,5212,6199,759,987,228,0.231003039513678,25th-50th percentile
2092,39101,Ohio,Marion,1332,1474,188,142,-46,-0.323943661971831,Bottom 25th percentile
2093,39103,Ohio,Medina,2746,3206,339,460,121,0.26304347826087,50th-75th percentile
2094,39109,Ohio,Miami,2023,2338,332,315,-17,-0.053968253968254,Bottom 25th percentile
2095,39113,Ohio,Montgomery,10532,12250,1343,1718,375,0.218277066356228,25th-50th percentile
2096,39115,Ohio,Morgan,319,392,39,73,34,0.465753424657534,Top 25th percentile
2097,39127,Ohio,Perry,649,773,81,124,43,0.346774193548387,50th-75th percentile
2098,39119,Ohio,Muskingum,1767,1949,197,182,-15,-0.0824175824175824,Bottom 25th percentile
2099,39125,Ohio,Paulding,368,375,50,7,-43,-6.14285714285714,Bottom 25th percentile
2100,39137,Ohio,Putnam,558,690,119,132,13,0.0984848484848485,25th-50th percentile
2101,39161,Ohio,Van Wert,575,672,91,97,6,0.0618556701030928,25th-50th percentile
2102,39129,Ohio,Pickaway,1079,1227,159,148,-11,-0.0743243243243243,Bottom 25th percentile
2103,39133,Ohio,Portage,2666,2999,281,333,52,0.156156156156156,25th-50th percentile
2104,39141,Ohio,Ross,1476,1855,219,379,160,0.422163588390501,Top 25th percentile
2105,39143,Ohio,Sandusky,1192,1358,168,166,-2,-0.0120481927710843,25th-50th percentile
2106,39145,Ohio,Scioto,1761,2161,182,400,218,0.545,Top 25th percentile
2107,39147,Ohio,Seneca,1070,1245,153,175,22,0.125714285714286,25th-50th percentile
2108,39151,Ohio,Stark,7640,8987,1145,1347,202,0.14996288047513,25th-50th percentile
2109,39153,Ohio,Summit,10178,11536,1182,1358,176,0.12960235640648,25th-50th percentile
2110,39155,Ohio,Trumbull,4425,5265,610,840,230,0.273809523809524,50th-75th percentile
2111,39159,Ohio,Union,744,823,69,79,10,0.126582278481013,25th-50th percentile
2112,39165,Ohio,Warren,3253,3832,420,579,159,0.274611398963731,50th-75th percentile
2113,39167,Ohio,Washington,1316,1450,156,134,-22,-0.164179104477612,Bottom 25th percentile
2114,39169,Ohio,Wayne,2050,2373,299,323,24,0.0743034055727554,25th-50th percentile
2115,39173,Ohio,Wood,2096,2345,238,249,11,0.0441767068273092,25th-50th percentile
2116,40001,Oklahoma,Adair,432,533,84,101,17,0.168316831683168,25th-50th percentile
2117,40021,Oklahoma,Cherokee,840,1068,120,228,108,0.473684210526316,Top 25th percentile
2118,40135,Oklahoma,Sequoyah,908,1177,150,269,119,0.442379182156134,Top 25th percentile
2119,40005,Oklahoma,Atoka,311,349,50,38,-12,-0.315789473684211,Bottom 25th percentile
2120,40013,Oklahoma,Bryan,922,1156,162,234,72,0.307692307692308,50th-75th percentile
2121,40029,Oklahoma,Coal,145,166,16,21,5,0.238095238095238,25th-50th percentile
2122,40009,Oklahoma,Beckham,394,498,77,104,27,0.259615384615385,50th-75th percentile
2123,40039,Oklahoma,Custer,538,626,116,88,-28,-0.318181818181818,Bottom 25th percentile
2124,40129,Oklahoma,Roger Mills,62,88,14,26,12,0.461538461538462,Top 25th percentile
2125,40149,Oklahoma,Washita,239,277,39,38,-1,-0.0263157894736842,25th-50th percentile
2126,40015,Oklahoma,Caddo,638,750,145,112,-33,-0.294642857142857,Bottom 25th percentile
2127,40051,Oklahoma,Grady,984,1215,186,231,45,0.194805194805195,25th-50th percentile
2128,40017,Oklahoma,Canadian,1952,2226,316,274,-42,-0.153284671532847,Bottom 25th percentile
2129,40019,Oklahoma,Carter,968,1285,190,317,127,0.400630914826498,50th-75th percentile
2130,40069,Oklahoma,Johnston,228,272,52,44,-8,-0.181818181818182,Bottom 25th percentile
2131,40085,Oklahoma,Love,198,246,38,48,10,0.208333333333333,25th-50th percentile
2132,40095,Oklahoma,Marshall,361,436,48,75,27,0.36,50th-75th percentile
2133,40023,Oklahoma,Choctaw,350,489,75,139,64,0.460431654676259,Top 25th percentile
2134,40089,Oklahoma,McCurtain,683,968,187,285,98,0.343859649122807,50th-75th percentile
2135,40127,Oklahoma,Pushmataha,289,377,52,88,36,0.409090909090909,50th-75th percentile
2136,40027,Oklahoma,Cleveland,3581,4220,503,639,136,0.21283255086072,25th-50th percentile
2137,40031,Oklahoma,Comanche,1778,2267,296,489,193,0.394683026584867,50th-75th percentile
2138,40033,Oklahoma,Cotton,126,175,26,49,23,0.469387755102041,Top 25th percentile
2139,40067,Oklahoma,Jefferson,146,178,16,32,16,0.5,Top 25th percentile
2140,40137,Oklahoma,Stephens,992,1140,146,148,2,0.0135135135135135,25th-50th percentile
2141,40035,Oklahoma,Craig,357,393,42,36,-6,-0.166666666666667,Bottom 25th percentile
2142,40097,Oklahoma,Mayes,851,1031,126,180,54,0.3,50th-75th percentile
2143,40037,Oklahoma,Creek,1482,1748,267,266,-1,-0.0037593984962406,25th-50th percentile
2144,40041,Oklahoma,Delaware,977,1234,190,257,67,0.260700389105058,50th-75th percentile
2145,40115,Oklahoma,Ottawa,752,901,120,149,29,0.194630872483221,25th-50th percentile
2146,40047,Oklahoma,Garfield,1193,1444,197,251,54,0.215139442231076,25th-50th percentile
2147,40049,Oklahoma,Garvin,610,740,106,130,24,0.184615384615385,25th-50th percentile
2148,40087,Oklahoma,McClain,686,750,105,64,-41,-0.640625,Bottom 25th percentile
2149,40099,Oklahoma,Murray,345,389,49,44,-5,-0.113636363636364,Bottom 25th percentile
2150,40053,Oklahoma,Grant,107,121,9,14,5,0.357142857142857,50th-75th percentile
2151,40071,Oklahoma,Kay,1003,1186,177,183,6,0.0327868852459016,25th-50th percentile
2152,40061,Oklahoma,Haskell,308,335,42,27,-15,-0.555555555555556,Bottom 25th percentile
2153,40077,Oklahoma,Latimer,253,244,31,-9,-40,4.44444444444444,Top 25th percentile
2154,40121,Oklahoma,Pittsburg,1036,1330,173,294,121,0.41156462585034,50th-75th percentile
2155,40063,Oklahoma,Hughes,339,376,54,37,-17,-0.45945945945946,Bottom 25th percentile
2156,40107,Oklahoma,Okfuskee,333,345,52,12,-40,-3.33333333333333,Bottom 25th percentile
2157,40123,Oklahoma,Pontotoc,756,932,112,176,64,0.363636363636364,50th-75th percentile
2158,40133,Oklahoma,Seminole,585,727,99,142,43,0.302816901408451,50th-75th percentile
2159,40079,Oklahoma,Le Flore,1108,1303,148,195,47,0.241025641025641,25th-50th percentile
2160,40081,Oklahoma,Lincoln,668,788,114,120,6,0.05,25th-50th percentile
2161,40083,Oklahoma,Logan,678,792,99,114,15,0.131578947368421,25th-50th percentile
2162,40091,Oklahoma,McIntosh,527,666,96,139,43,0.309352517985612,50th-75th percentile
2163,40111,Oklahoma,Okmulgee,897,1108,149,211,62,0.293838862559242,50th-75th percentile
2164,40003,Oklahoma,Alfalfa,102,121,7,19,12,0.631578947368421,Top 25th percentile
2165,40011,Oklahoma,Blaine,221,265,37,44,7,0.159090909090909,25th-50th percentile
2166,40043,Oklahoma,Dewey,117,129,15,12,-3,-0.25,Bottom 25th percentile
2167,40073,Oklahoma,Kingfisher,307,316,51,9,-42,-4.66666666666667,Bottom 25th percentile
2168,40093,Oklahoma,Major,174,190,30,16,-14,-0.875,Bottom 25th percentile
2169,40151,Oklahoma,Woods,170,172,23,2,-21,-10.5,Bottom 25th percentile
2170,40101,Oklahoma,Muskogee,1559,1891,272,332,60,0.180722891566265,25th-50th percentile
2171,40103,Oklahoma,Noble,244,282,33,38,5,0.131578947368421,25th-50th percentile
2172,40113,Oklahoma,Osage,802,951,125,149,24,0.161073825503356,25th-50th percentile
2173,40117,Oklahoma,Pawnee,379,437,53,58,5,0.0862068965517242,25th-50th percentile
2174,40105,Oklahoma,Nowata,233,259,31,26,-5,-0.192307692307692,Bottom 25th percentile
2175,40147,Oklahoma,Washington,1140,1317,190,177,-13,-0.0734463276836158,Bottom 25th percentile
2176,40109,Oklahoma,Oklahoma (county),12547,14854,1796,2307,511,0.221499783268314,25th-50th percentile
2177,40007,Oklahoma,Beaver,88,106,18,18,0,0.0,25th-50th percentile
2178,40025,Oklahoma,Cimarron,48,45,4,-3,-7,2.33333333333333,Top 25th percentile
2179,40045,Oklahoma,Ellis,87,92,11,5,-6,-1.2,Bottom 25th percentile
2180,40059,Oklahoma,Harper,68,81,14,13,-1,-0.0769230769230769,Bottom 25th percentile
2181,40139,Oklahoma,Texas,299,308,53,9,-44,-4.88888888888889,Bottom 25th percentile
2182,40153,Oklahoma,Woodward,338,416,53,78,25,0.320512820512821,50th-75th percentile
2183,40119,Oklahoma,Payne,1062,1228,126,166,40,0.240963855421687,25th-50th percentile
2184,40125,Oklahoma,Pottawatomie,1485,1809,203,324,121,0.373456790123457,50th-75th percentile
2185,40131,Oklahoma,Rogers,1602,1922,250,320,70,0.21875,25th-50th percentile
2186,40055,Oklahoma,Greer,118,153,23,35,12,0.342857142857143,50th-75th percentile
2187,40057,Oklahoma,Harmon,50,77,13,27,14,0.518518518518519,Top 25th percentile
2188,40065,Oklahoma,Jackson,427,518,82,91,9,0.0989010989010989,25th-50th percentile
2189,40075,Oklahoma,Kiowa,270,279,44,9,-35,-3.88888888888889,Bottom 25th percentile
2190,40141,Oklahoma,Tillman,163,200,31,37,6,0.162162162162162,25th-50th percentile
2191,40143,Oklahoma,Tulsa,10376,12531,1640,2155,515,0.238979118329466,25th-50th percentile
2192,40145,Oklahoma,Wagoner,1143,1446,212,303,91,0.3003300330033,50th-75th percentile
2193,41001,Oregon,Baker,367,429,22,62,40,0.645161290322581,Top 25th percentile
2194,41025,Oregon,Harney,146,185,32,39,7,0.17948717948718,25th-50th percentile
2195,41037,Oregon,Lake,173,208,15,35,20,0.571428571428571,Top 25th percentile
2196,41045,Oregon,Malheur,537,663,81,126,45,0.357142857142857,50th-75th percentile
2197,41003,Oregon,Benton,1044,1134,26,90,64,0.711111111111111,Top 25th percentile
2198,41005,Oregon,Clackamas,6147,6557,361,410,49,0.119512195121951,25th-50th percentile
2199,41007,Oregon,Clatsop,694,799,33,105,72,0.685714285714286,Top 25th percentile
2200,41041,Oregon,Lincoln,1081,1183,42,102,60,0.588235294117647,Top 25th percentile
2201,41057,Oregon,Tillamook,541,640,40,99,59,0.595959595959596,Top 25th percentile
2202,41009,Oregon,Columbia,822,972,63,150,87,0.58,Top 25th percentile
2203,41067,Oregon,Washington,6168,6700,325,532,207,0.389097744360902,50th-75th percentile
2204,41011,Oregon,Coos,1592,1760,90,168,78,0.464285714285714,Top 25th percentile
2205,41015,Oregon,Curry,684,825,37,141,104,0.73758865248227,Top 25th percentile
2206,41017,Oregon,Deschutes,2757,2791,156,34,-122,-3.58823529411765,Bottom 25th percentile
2207,41019,Oregon,Douglas,2656,3157,247,501,254,0.506986027944112,Top 25th percentile
2208,41027,Oregon,Hood River,340,319,27,-21,-48,2.28571428571429,Top 25th percentile
2209,41031,Oregon,Jefferson,367,513,54,146,92,0.63013698630137,Top 25th percentile
2210,41055,Oregon,Sherman,33,42,7,9,2,0.222222222222222,25th-50th percentile
2211,41065,Oregon,Wasco,571,616,51,45,-6,-0.133333333333333,Bottom 25th percentile
2212,41029,Oregon,Jackson,4230,4725,304,495,191,0.385858585858586,50th-75th percentile
2213,41033,Oregon,Josephine,2164,2454,223,290,67,0.231034482758621,25th-50th percentile
2214,41035,Oregon,Klamath,1436,1671,147,235,88,0.374468085106383,50th-75th percentile
2215,41039,Oregon,Lane,6381,7139,277,758,481,0.634564643799472,Top 25th percentile
2216,41043,Oregon,Linn,2366,2708,167,342,175,0.511695906432749,Top 25th percentile
2217,41047,Oregon,Marion,5024,5496,428,472,44,0.0932203389830508,25th-50th percentile
2218,41051,Oregon,Multnomah,9995,10909,736,914,178,0.194748358862144,25th-50th percentile
2219,41053,Oregon,Polk,1278,1365,78,87,9,0.103448275862069,25th-50th percentile
2220,41013,Oregon,Crook,497,475,42,-22,-64,2.90909090909091,Top 25th percentile
2221,41021,Oregon,Gilliam,37,38,10,1,-9,-9.0,Bottom 25th percentile
2222,41023,Oregon,Grant,153,182,16,29,13,0.448275862068966,Top 25th percentile
2223,41049,Oregon,Morrow,149,200,23,51,28,0.549019607843137,Top 25th percentile
2224,41059,Oregon,Umatilla,1175,1451,146,276,130,0.471014492753623,Top 25th percentile
2225,41061,Oregon,Union,504,548,44,44,0,0.0,25th-50th percentile
2226,41063,Oregon,Wallowa,149,153,4,4,0,0.0,25th-50th percentile
2227,41069,Oregon,Wheeler,31,33,7,2,-5,-2.5,Bottom 25th percentile
2228,41071,Oregon,Yamhill,1695,1921,114,226,112,0.495575221238938,Top 25th percentile
2229,42001,Pennsylvania,Adams,1852,2021,196,169,-27,-0.159763313609467,Bottom 25th percentile
2230,42003,Pennsylvania,Allegheny,23270,25403,2137,2133,-4,-0.0018752930145335,25th-50th percentile
2231,42005,Pennsylvania,Armstrong,1438,1652,155,214,59,0.275700934579439,50th-75th percentile
2232,42007,Pennsylvania,Beaver,3743,4135,430,392,-38,-0.0969387755102041,Bottom 25th percentile
2233,42009,Pennsylvania,Bedford,980,1188,179,208,29,0.139423076923077,25th-50th percentile
2234,42057,Pennsylvania,Fulton,298,338,36,40,4,0.1,25th-50th percentile
2235,42011,Pennsylvania,Berks,6981,7910,1064,929,-135,-0.145317545748116,Bottom 25th percentile
2236,42013,Pennsylvania,Blair,2771,3106,378,335,-43,-0.128358208955224,Bottom 25th percentile
2237,42015,Pennsylvania,Bradford,1210,1296,123,86,-37,-0.430232558139535,Bottom 25th percentile
2238,42113,Pennsylvania,Sullivan,170,204,19,34,15,0.441176470588235,Top 25th percentile
2239,42017,Pennsylvania,Bucks,10605,12044,1335,1439,104,0.0722724113968033,25th-50th percentile
2240,42019,Pennsylvania,Butler,3566,3989,454,423,-31,-0.0732860520094563,Bottom 25th percentile
2241,42021,Pennsylvania,Cambria,3125,3559,481,434,-47,-0.108294930875576,Bottom 25th percentile
2242,42025,Pennsylvania,Carbon,1348,1595,206,247,41,0.165991902834008,25th-50th percentile
2243,42027,Pennsylvania,Centre,1741,2085,221,344,123,0.357558139534884,50th-75th percentile
2244,42029,Pennsylvania,Chester,7109,7684,813,575,-238,-0.413913043478261,Bottom 25th percentile
2245,42031,Pennsylvania,Clarion,723,931,118,208,90,0.432692307692308,Top 25th percentile
2246,42065,Pennsylvania,Jefferson,949,1043,125,94,-31,-0.329787234042553,Bottom 25th percentile
2247,42033,Pennsylvania,Clearfield,1669,1833,192,164,-28,-0.170731707317073,Bottom 25th percentile
2248,42035,Pennsylvania,Clinton,726,762,72,36,-36,-1.0,Bottom 25th percentile
2249,42105,Pennsylvania,Potter,373,418,45,45,0,0.0,25th-50th percentile
2250,42117,Pennsylvania,Tioga,814,909,138,95,-43,-0.452631578947368,Bottom 25th percentile
2251,42037,Pennsylvania,Columbia,1214,1399,156,185,29,0.156756756756757,25th-50th percentile
2252,42039,Pennsylvania,Crawford,1704,1923,174,219,45,0.205479452054795,25th-50th percentile
2253,42041,Pennsylvania,Cumberland,4270,4762,593,492,-101,-0.205284552845528,Bottom 25th percentile
2254,42099,Pennsylvania,Perry,784,911,116,127,11,0.0866141732283465,25th-50th percentile
2255,42043,Pennsylvania,Dauphin,4435,5145,600,710,110,0.154929577464789,25th-50th percentile
2256,42045,Pennsylvania,Delaware,9506,10710,1429,1204,-225,-0.18687707641196,Bottom 25th percentile
2257,42049,Pennsylvania,Erie,4993,5586,476,593,117,0.197301854974705,25th-50th percentile
2258,42051,Pennsylvania,Fayette,3066,3473,407,407,0,0.0,25th-50th percentile
2259,42059,Pennsylvania,Greene,760,869,72,109,37,0.339449541284404,50th-75th percentile
2260,42055,Pennsylvania,Franklin,2819,3449,426,630,204,0.323809523809524,50th-75th percentile
2261,42061,Pennsylvania,Huntingdon,821,962,141,141,0,0.0,25th-50th percentile
2262,42067,Pennsylvania,Juniata,448,578,106,130,24,0.184615384615385,25th-50th percentile
2263,42087,Pennsylvania,Mifflin,981,1188,194,207,13,0.0628019323671498,25th-50th percentile
2264,42063,Pennsylvania,Indiana,1526,1826,207,300,93,0.31,50th-75th percentile
2265,42069,Pennsylvania,Lackawanna,4643,4948,492,305,-187,-0.613114754098361,Bottom 25th percentile
2266,42131,Pennsylvania,Wyoming,557,596,58,39,-19,-0.487179487179487,Bottom 25th percentile
2267,42071,Pennsylvania,Lancaster,8969,10109,1267,1140,-127,-0.11140350877193,Bottom 25th percentile
2268,42073,Pennsylvania,Lawrence,1997,2339,259,342,83,0.242690058479532,50th-75th percentile
2269,42075,Pennsylvania,Lebanon,2723,3131,319,408,89,0.218137254901961,25th-50th percentile
2270,42077,Pennsylvania,Lehigh,5944,6638,880,694,-186,-0.268011527377522,Bottom 25th percentile
2271,42079,Pennsylvania,Luzerne,7086,7847,847,761,-86,-0.113009198423127,Bottom 25th percentile
2272,42081,Pennsylvania,Lycoming,2251,2566,307,315,8,0.0253968253968254,25th-50th percentile
2273,42023,Pennsylvania,Cameron,108,122,8,14,6,0.428571428571429,Top 25th percentile
2274,42047,Pennsylvania,Elk,646,691,59,45,-14,-0.311111111111111,Bottom 25th percentile
2275,42053,Pennsylvania,Forest,148,173,17,25,8,0.32,50th-75th percentile
2276,42083,Pennsylvania,McKean,908,968,101,60,-41,-0.683333333333333,Bottom 25th percentile
2277,42123,Pennsylvania,Warren,874,1046,94,172,78,0.453488372093023,Top 25th percentile
2278,42085,Pennsylvania,Mercer,2526,2967,326,441,115,0.260770975056689,50th-75th percentile
2279,42089,Pennsylvania,Monroe,2594,3006,366,412,46,0.111650485436893,25th-50th percentile
2280,42091,Pennsylvania,Montgomery,13546,14899,1728,1353,-375,-0.277161862527716,Bottom 25th percentile
2281,42093,Pennsylvania,Montour,402,431,68,29,-39,-1.3448275862069,Bottom 25th percentile
2282,42097,Pennsylvania,Northumberland,2019,2279,379,260,-119,-0.457692307692308,Bottom 25th percentile
2283,42095,Pennsylvania,Northampton,5328,6066,709,738,29,0.0392953929539295,25th-50th percentile
2284,42101,Pennsylvania,Philadelphia,23528,27953,3766,4425,659,0.148926553672316,25th-50th percentile
2285,42103,Pennsylvania,Pike,911,1077,100,166,66,0.397590361445783,50th-75th percentile
2286,42107,Pennsylvania,Schuylkill,3308,3705,420,397,-23,-0.0579345088161209,Bottom 25th percentile
2287,42109,Pennsylvania,Snyder,634,718,93,84,-9,-0.107142857142857,Bottom 25th percentile
2288,42119,Pennsylvania,Union,662,812,91,150,59,0.393333333333333,50th-75th percentile
2289,42111,Pennsylvania,Somerset,1669,1902,239,233,-6,-0.0257510729613734,25th-50th percentile
2290,42115,Pennsylvania,Susquehanna,831,928,63,97,34,0.350515463917526,50th-75th percentile
2291,42127,Pennsylvania,Wayne,1044,1283,110,239,129,0.539748953974895,Top 25th percentile
2292,42121,Pennsylvania,Venango,1114,1345,141,231,90,0.38961038961039,50th-75th percentile
2293,42125,Pennsylvania,Washington,4421,4768,365,347,-18,-0.0518731988472623,Bottom 25th percentile
2294,42129,Pennsylvania,Westmoreland,7739,8605,804,866,62,0.0715935334872979,25th-50th percentile
2295,42133,Pennsylvania,York,7226,8393,893,1167,274,0.234790059982862,25th-50th percentile
2296,44001,Rhode Island,Bristol,906,1000,122,94,-28,-0.297872340425532,Bottom 25th percentile
2297,44007,Rhode Island,Providence,9698,11103,1665,1405,-260,-0.185053380782918,Bottom 25th percentile
2298,44003,Rhode Island,Kent,3093,3444,324,351,27,0.0769230769230769,25th-50th percentile
2299,44005,Rhode Island,Newport,1432,1471,81,39,-42,-1.07692307692308,Bottom 25th percentile
2300,44009,Rhode Island,Washington,2111,2335,135,224,89,0.397321428571429,50th-75th percentile
2301,45001,South Carolina,Abbeville,544,654,68,110,42,0.381818181818182,50th-75th percentile
2302,45037,South Carolina,Edgefield,427,605,78,178,100,0.561797752808989,Top 25th percentile
2303,45047,South Carolina,Greenwood,1442,1664,185,222,37,0.166666666666667,25th-50th percentile
2304,45065,South Carolina,McCormick,249,300,30,51,21,0.411764705882353,50th-75th percentile
2305,45003,South Carolina,Aiken,3206,3919,489,713,224,0.314165497896213,50th-75th percentile
2306,45007,South Carolina,Anderson,3952,4893,699,941,242,0.257173219978746,50th-75th percentile
2307,45013,South Carolina,Beaufort,2917,3369,271,452,181,0.400442477876106,50th-75th percentile
2308,45015,South Carolina,Berkeley,2818,3298,365,480,115,0.239583333333333,25th-50th percentile
2309,45017,South Carolina,Calhoun,325,388,51,63,12,0.19047619047619,25th-50th percentile
2310,45079,South Carolina,Richland,5429,6474,680,1045,365,0.349282296650718,50th-75th percentile
2311,45019,South Carolina,Charleston,5832,6233,595,401,-194,-0.483790523690773,Bottom 25th percentile
2312,45021,South Carolina,Cherokee,1166,1471,246,305,59,0.19344262295082,25th-50th percentile
2313,45023,South Carolina,Chester,737,929,114,192,78,0.40625,50th-75th percentile
2314,45039,South Carolina,Fairfield,502,657,86,155,69,0.445161290322581,Top 25th percentile
2315,45025,South Carolina,Chesterfield,924,1188,165,264,99,0.375,50th-75th percentile
2316,45069,South Carolina,Marlboro,597,738,105,141,36,0.25531914893617,50th-75th percentile
2317,45027,South Carolina,Clarendon,703,978,143,275,132,0.48,Top 25th percentile
2318,45089,South Carolina,Williamsburg,700,919,148,219,71,0.324200913242009,50th-75th percentile
2319,45031,South Carolina,Darlington,1487,1816,232,329,97,0.29483282674772,50th-75th percentile
2320,45033,South Carolina,Dillon,664,835,107,171,64,0.374269005847953,50th-75th percentile
2321,45067,South Carolina,Marion,723,915,155,192,37,0.192708333333333,25th-50th percentile
2322,45035,South Carolina,Dorchester,2128,2527,299,399,100,0.25062656641604,50th-75th percentile
2323,45041,South Carolina,Florence,2722,3460,490,738,248,0.336043360433604,50th-75th percentile
2324,45043,South Carolina,Georgetown,1393,1779,201,386,185,0.479274611398964,Top 25th percentile
2325,45045,South Carolina,Greenville,7787,9001,1136,1214,78,0.0642504118616145,25th-50th percentile
2326,45005,South Carolina,Allendale,199,247,28,48,20,0.416666666666667,Top 25th percentile
2327,45009,South Carolina,Bamberg,345,435,51,90,39,0.433333333333333,Top 25th percentile
2328,45011,South Carolina,Barnwell,459,542,75,83,8,0.0963855421686747,25th-50th percentile
2329,45029,South Carolina,Colleton,938,1157,171,219,48,0.219178082191781,25th-50th percentile
2330,45049,South Carolina,Hampton,405,491,64,86,22,0.255813953488372,50th-75th percentile
2331,45053,South Carolina,Jasper,488,560,86,72,-14,-0.194444444444444,Bottom 25th percentile
2332,45051,South Carolina,Horry,6823,8283,912,1460,548,0.375342465753425,50th-75th percentile
2333,45055,South Carolina,Kershaw,1246,1523,170,277,107,0.386281588447653,50th-75th percentile
2334,45061,South Carolina,Lee,427,507,90,80,-10,-0.125,Bottom 25th percentile
2335,45057,South Carolina,Lancaster,1693,1978,236,285,49,0.171929824561404,25th-50th percentile
2336,45059,South Carolina,Laurens,1523,1731,218,208,-10,-0.0480769230769231,Bottom 25th percentile
2337,45063,South Carolina,Lexington,4545,5250,578,705,127,0.180141843971631,25th-50th percentile
2338,45071,South Carolina,Newberry,759,967,127,208,81,0.389423076923077,50th-75th percentile
2339,45081,South Carolina,Saluda,376,511,65,135,70,0.518518518518519,Top 25th percentile
2340,45073,South Carolina,Oconee,1630,1839,220,209,-11,-0.0526315789473684,Bottom 25th percentile
2341,45075,South Carolina,Orangeburg,1816,2294,297,478,181,0.378661087866109,50th-75th percentile
2342,45077,South Carolina,Pickens,2170,2722,387,552,165,0.298913043478261,50th-75th percentile
2343,45083,South Carolina,Spartanburg,5612,6824,1054,1212,158,0.13036303630363,25th-50th percentile
2344,45087,South Carolina,Union,672,833,108,161,53,0.329192546583851,50th-75th percentile
2345,45085,South Carolina,Sumter,1988,2468,297,480,183,0.38125,50th-75th percentile
2346,45091,South Carolina,York,3861,4389,513,528,15,0.0284090909090909,25th-50th percentile
2347,46005,South Dakota,Beadle,357,338,41,-19,-60,3.15789473684211,Top 25th percentile
2348,46025,South Dakota,Clark,72,63,6,-9,-15,1.66666666666667,Top 25th percentile
2349,46029,South Dakota,Codington,431,538,81,107,26,0.242990654205607,50th-75th percentile
2350,46039,South Dakota,Deuel,86,79,8,-7,-15,2.14285714285714,Top 25th percentile
2351,46057,South Dakota,Hamlin,115,141,33,26,-7,-0.269230769230769,Bottom 25th percentile
2352,46077,South Dakota,Kingsbury,110,118,20,8,-12,-1.5,Bottom 25th percentile
2353,46115,South Dakota,Spink,128,144,24,16,-8,-0.5,Bottom 25th percentile
2354,46027,South Dakota,Clay,188,191,17,3,-14,-4.66666666666667,Bottom 25th percentile
2355,46125,South Dakota,Turner,188,214,41,26,-15,-0.576923076923077,Bottom 25th percentile
2356,46127,South Dakota,Union,236,260,34,24,-10,-0.416666666666667,Bottom 25th percentile
2357,46135,South Dakota,Yankton,427,460,31,33,2,0.0606060606060606,25th-50th percentile
2358,46003,South Dakota,Aurora,52,82,17,30,13,0.433333333333333,Top 25th percentile
2359,46009,South Dakota,Bon Homme,140,189,23,49,26,0.530612244897959,Top 25th percentile
2360,46015,South Dakota,Brule,94,82,9,-12,-21,1.75,Top 25th percentile
2361,46023,South Dakota,Charles Mix,192,226,20,34,14,0.411764705882353,50th-75th percentile
2362,46035,South Dakota,Davison,396,414,56,18,-38,-2.11111111111111,Bottom 25th percentile
2363,46043,South Dakota,Douglas,77,81,17,4,-13,-3.25,Bottom 25th percentile
2364,46067,South Dakota,Hutchinson,198,187,21,-11,-32,2.90909090909091,Top 25th percentile
2365,46083,South Dakota,Lincoln,532,576,67,44,-23,-0.522727272727273,Bottom 25th percentile
2366,46099,South Dakota,Minnehaha,2629,2994,351,365,14,0.0383561643835616,25th-50th percentile
2367,46011,South Dakota,Brookings,355,378,34,23,-11,-0.478260869565217,Bottom 25th percentile
2368,46061,South Dakota,Hanson,42,47,6,5,-1,-0.2,Bottom 25th percentile
2369,46073,South Dakota,Jerauld,52,37,17,-15,-32,2.13333333333333,Top 25th percentile
2370,46079,South Dakota,Lake,208,187,18,-21,-39,1.85714285714286,Top 25th percentile
2371,46087,South Dakota,McCook,131,138,25,7,-18,-2.57142857142857,Bottom 25th percentile
2372,46097,South Dakota,Miner,53,62,5,9,4,0.444444444444444,Top 25th percentile
2373,46101,South Dakota,Moody,104,132,23,28,5,0.178571428571429,25th-50th percentile
2374,46111,South Dakota,Sanborn,47,39,9,-8,-17,2.125,Top 25th percentile
2375,46017,South Dakota,Buffalo,33,64,15,31,16,0.516129032258065,Top 25th percentile
2376,46021,South Dakota,Campbell,25,39,16,14,-2,-0.142857142857143,Bottom 25th percentile
2377,46045,South Dakota,Edmunds,68,96,14,28,14,0.5,Top 25th percentile
2378,46049,South Dakota,Faulk,62,67,10,5,-5,-1.0,Bottom 25th percentile
2379,46059,South Dakota,Hand,85,93,7,8,1,0.125,25th-50th percentile
2380,46065,South Dakota,Hughes,325,348,41,23,-18,-0.782608695652174,Bottom 25th percentile
2381,46069,South Dakota,Hyde,39,47,13,8,-5,-0.625,Bottom 25th percentile
2382,46085,South Dakota,Lyman,58,85,4,27,23,0.851851851851852,Top 25th percentile
2383,46089,South Dakota,McPherson,64,68,3,4,1,0.25,50th-75th percentile
2384,46107,South Dakota,Potter,59,64,6,5,-1,-0.2,Bottom 25th percentile
2385,46117,South Dakota,Stanley,35,42,8,7,-1,-0.142857142857143,Bottom 25th percentile
2386,46119,South Dakota,Sully,23,26,11,3,-8,-2.66666666666667,Bottom 25th percentile
2387,46129,South Dakota,Walworth,129,141,19,12,-7,-0.583333333333333,Bottom 25th percentile
2388,46013,South Dakota,Brown,630,703,87,73,-14,-0.191780821917808,Bottom 25th percentile
2389,46037,South Dakota,Day,129,150,31,21,-10,-0.476190476190476,Bottom 25th percentile
2390,46051,South Dakota,Grant,152,180,35,28,-7,-0.25,Bottom 25th percentile
2391,46091,South Dakota,Marshall,78,89,12,11,-1,-0.0909090909090909,Bottom 25th percentile
2392,46109,South Dakota,Roberts,190,215,39,25,-14,-0.56,Bottom 25th percentile
2393,46019,South Dakota,Butte,200,217,31,17,-14,-0.823529411764706,Bottom 25th percentile
2394,46031,South Dakota,Corson,90,94,18,4,-14,-3.5,Bottom 25th percentile
2395,46041,South Dakota,Dewey,93,143,24,50,26,0.52,Top 25th percentile
2396,46063,South Dakota,Harding,20,11,11,-9,-20,2.22222222222222,Top 25th percentile
2397,46081,South Dakota,Lawrence,425,507,61,82,21,0.25609756097561,50th-75th percentile
2398,46093,South Dakota,Meade,390,399,40,9,-31,-3.44444444444444,Bottom 25th percentile
2399,46105,South Dakota,Perkins,68,82,13,14,1,0.0714285714285714,25th-50th percentile
2400,46137,South Dakota,Ziebach,27,54,7,27,20,0.740740740740741,Top 25th percentile
2401,46103,South Dakota,Pennington,1719,2017,226,298,72,0.241610738255034,25th-50th percentile
2402,46007,South Dakota,Bennett,60,72,5,12,7,0.583333333333333,Top 25th percentile
2403,46033,South Dakota,Custer,172,165,16,-7,-23,3.28571428571429,Top 25th percentile
2404,46047,South Dakota,Fall River,197,238,9,41,32,0.780487804878049,Top 25th percentile
2405,46053,South Dakota,Gregory,104,141,29,37,8,0.216216216216216,25th-50th percentile
2406,46055,South Dakota,Haakon,44,42,12,-2,-14,7.0,Top 25th percentile
2407,46071,South Dakota,Jackson,52,93,16,41,25,0.609756097560976,Top 25th percentile
2408,46075,South Dakota,Jones,24,15,6,-9,-15,1.66666666666667,Top 25th percentile
2409,46095,South Dakota,Mellette,49,49,7,0,-7,-inf,Bottom 25th percentile
2410,46102,South Dakota,Southwest Central South Dakota,263,322,39,59,20,0.338983050847458,50th-75th percentile
2411,46121,South Dakota,Todd,134,188,28,54,26,0.481481481481482,Top 25th percentile
2412,46123,South Dakota,Tripp,130,138,15,8,-7,-0.875,Bottom 25th percentile
2413,47001,Tennessee,Anderson,1759,1968,184,209,25,0.119617224880383,25th-50th percentile
2414,47003,Tennessee,Bedford,918,1064,167,146,-21,-0.143835616438356,Bottom 25th percentile
2415,47103,Tennessee,Lincoln,769,939,127,170,43,0.252941176470588,50th-75th percentile
2416,47127,Tennessee,Moore,120,144,19,24,5,0.208333333333333,25th-50th percentile
2417,47005,Tennessee,Benton,439,546,82,107,25,0.233644859813084,25th-50th percentile
2418,47017,Tennessee,Carroll,741,875,118,134,16,0.119402985074627,25th-50th percentile
2419,47079,Tennessee,Henry,812,972,106,160,54,0.3375,50th-75th percentile
2420,47007,Tennessee,Bledsoe,263,295,38,32,-6,-0.1875,Bottom 25th percentile
2421,47143,Tennessee,Rhea,747,917,104,170,66,0.388235294117647,50th-75th percentile
2422,47175,Tennessee,Van Buren,154,204,39,50,11,0.22,25th-50th percentile
2423,47185,Tennessee,White,654,781,102,127,25,0.196850393700787,25th-50th percentile
2424,47009,Tennessee,Blount,2591,3037,269,446,177,0.396860986547085,50th-75th percentile
2425,47105,Tennessee,Loudon,1201,1313,133,112,-21,-0.1875,Bottom 25th percentile
2426,47011,Tennessee,Bradley,2009,2528,264,519,255,0.491329479768786,Top 25th percentile
2427,47139,Tennessee,Polk,429,537,53,108,55,0.509259259259259,Top 25th percentile
2428,47013,Tennessee,Campbell,1053,1206,108,153,45,0.294117647058824,50th-75th percentile
2429,47025,Tennessee,Claiborne,750,943,132,193,61,0.316062176165803,50th-75th percentile
2430,47067,Tennessee,Hancock,173,204,19,31,12,0.387096774193548,50th-75th percentile
2431,47151,Tennessee,Scott,477,558,71,81,10,0.123456790123457,25th-50th percentile
2432,47015,Tennessee,Cannon,334,356,42,22,-20,-0.909090909090909,Bottom 25th percentile
2433,47041,Tennessee,DeKalb,449,536,67,87,20,0.229885057471264,25th-50th percentile
2434,47177,Tennessee,Warren,903,1007,128,104,-24,-0.230769230769231,Bottom 25th percentile
2435,47019,Tennessee,Carter,1348,1608,202,260,58,0.223076923076923,25th-50th percentile
2436,47091,Tennessee,Johnson,462,476,60,14,-46,-3.28571428571429,Bottom 25th percentile
2437,47171,Tennessee,Unicoi,517,606,52,89,37,0.415730337078652,Top 25th percentile
2438,47021,Tennessee,Cheatham,726,851,87,125,38,0.304,50th-75th percentile
2439,47043,Tennessee,Dickson,1019,1157,194,138,-56,-0.405797101449275,Bottom 25th percentile
2440,47023,Tennessee,Chester,347,427,63,80,17,0.2125,25th-50th percentile
2441,47113,Tennessee,Madison,1834,2205,316,371,55,0.148247978436658,25th-50th percentile
2442,47029,Tennessee,Cocke,943,1176,147,233,86,0.369098712446352,50th-75th percentile
2443,47089,Tennessee,Jefferson,1176,1419,182,243,61,0.251028806584362,50th-75th percentile
2444,47031,Tennessee,Coffee,1220,1413,182,193,11,0.0569948186528497,25th-50th percentile
2445,47051,Tennessee,Franklin,887,1112,125,225,100,0.444444444444444,Top 25th percentile
2446,47033,Tennessee,Crockett,352,407,48,55,7,0.127272727272727,25th-50th percentile
2447,47053,Tennessee,Gibson,1197,1534,177,337,160,0.474777448071217,Top 25th percentile
2448,47075,Tennessee,Haywood,378,485,77,107,30,0.280373831775701,50th-75th percentile
2449,47035,Tennessee,Cumberland,1506,1918,225,412,187,0.453883495145631,Top 25th percentile
2450,47049,Tennessee,Fentress,463,578,79,115,36,0.31304347826087,50th-75th percentile
2451,47037,Tennessee,Davidson,9078,10161,1159,1083,-76,-0.0701754385964912,Bottom 25th percentile
2452,47039,Tennessee,Decatur,323,390,42,67,25,0.373134328358209,50th-75th percentile
2453,47077,Tennessee,Henderson,602,763,122,161,39,0.242236024844721,50th-75th percentile
2454,47101,Tennessee,Lewis,307,349,41,42,1,0.0238095238095238,25th-50th percentile
2455,47135,Tennessee,Perry,214,218,37,4,-33,-8.25,Bottom 25th percentile
2456,47045,Tennessee,Dyer,848,1076,139,228,89,0.390350877192982,50th-75th percentile
2457,47095,Tennessee,Lake,171,203,27,32,5,0.15625,25th-50th percentile
2458,47097,Tennessee,Lauderdale,526,613,79,87,8,0.0919540229885057,25th-50th percentile
2459,47047,Tennessee,Fayette,762,946,118,184,66,0.358695652173913,50th-75th percentile
2460,47069,Tennessee,Hardeman,526,664,89,138,49,0.355072463768116,50th-75th percentile
2461,47055,Tennessee,Giles,673,869,115,196,81,0.413265306122449,Top 25th percentile
2462,47117,Tennessee,Marshall,673,777,92,104,12,0.115384615384615,25th-50th percentile
2463,47057,Tennessee,Grainger,533,651,80,118,38,0.322033898305085,50th-75th percentile
2464,47063,Tennessee,Hamblen,1375,1852,235,477,242,0.507337526205451,Top 25th percentile
2465,47059,Tennessee,Greene,1691,2051,236,360,124,0.344444444444444,50th-75th percentile
2466,47061,Tennessee,Grundy,367,412,55,45,-10,-0.222222222222222,Bottom 25th percentile
2467,47115,Tennessee,Marion,634,768,104,134,30,0.223880597014925,25th-50th percentile
2468,47153,Tennessee,Sequatchie,304,356,56,52,-4,-0.0769230769230769,Bottom 25th percentile
2469,47065,Tennessee,Hamilton,6605,7398,726,793,67,0.0844892812105927,25th-50th percentile
2470,47071,Tennessee,Hardin,678,831,102,153,51,0.333333333333333,50th-75th percentile
2471,47109,Tennessee,McNairy,671,771,76,100,24,0.24,25th-50th percentile
2472,47073,Tennessee,Hawkins,1314,1654,176,340,164,0.482352941176471,Top 25th percentile
2473,47081,Tennessee,Hickman,505,630,88,125,37,0.296,50th-75th percentile
2474,47083,Tennessee,Houston,207,259,39,52,13,0.25,50th-75th percentile
2475,47085,Tennessee,Humphreys,435,535,58,100,42,0.42,Top 25th percentile
2476,47161,Tennessee,Stewart,317,333,43,16,-27,-1.6875,Bottom 25th percentile
2477,47087,Tennessee,Jackson,312,329,42,17,-25,-1.47058823529412,Bottom 25th percentile
2478,47141,Tennessee,Putnam,1516,1804,201,288,87,0.302083333333333,50th-75th percentile
2479,47159,Tennessee,Smith,376,457,56,81,25,0.308641975308642,50th-75th percentile
2480,47093,Tennessee,Knox,7830,8988,821,1158,337,0.291018998272884,50th-75th percentile
2481,47173,Tennessee,Union,393,530,56,137,81,0.591240875912409,Top 25th percentile
2482,47099,Tennessee,Lawrence,990,1240,149,250,101,0.404,50th-75th percentile
2483,47181,Tennessee,Wayne,368,425,49,57,8,0.140350877192982,25th-50th percentile
2484,47107,Tennessee,McMinn,1255,1528,170,273,103,0.377289377289377,50th-75th percentile
2485,47121,Tennessee,Meigs,339,340,43,1,-42,-42.0,Bottom 25th percentile
2486,47123,Tennessee,Monroe,1072,1311,166,239,73,0.305439330543933,50th-75th percentile
2487,47119,Tennessee,Maury,1789,1938,236,149,-87,-0.583892617449665,Bottom 25th percentile
2488,47125,Tennessee,Montgomery,2405,3020,381,615,234,0.380487804878049,50th-75th percentile
2489,47129,Tennessee,Morgan,434,494,46,60,14,0.233333333333333,25th-50th percentile
2490,47145,Tennessee,Roane,1332,1509,154,177,23,0.129943502824859,25th-50th percentile
2491,47027,Tennessee,Clay,192,254,34,62,28,0.451612903225806,Top 25th percentile
2492,47111,Tennessee,Macon,481,588,97,107,10,0.0934579439252336,25th-50th percentile
2493,47133,Tennessee,Overton,559,688,88,129,41,0.317829457364341,50th-75th percentile
2494,47137,Tennessee,Pickett,136,147,19,11,-8,-0.727272727272727,Bottom 25th percentile
2495,47169,Tennessee,Trousdale,192,236,33,44,11,0.25,50th-75th percentile
2496,47131,Tennessee,Obion,695,893,136,198,62,0.313131313131313,50th-75th percentile
2497,47183,Tennessee,Weakley,701,813,88,112,24,0.214285714285714,25th-50th percentile
2498,47147,Tennessee,Robertson,1214,1539,176,325,149,0.458461538461538,Top 25th percentile
2499,47149,Tennessee,Rutherford,3789,4501,596,712,116,0.162921348314607,25th-50th percentile
2500,47155,Tennessee,Sevier,1904,2309,282,405,123,0.303703703703704,50th-75th percentile
2501,47157,Tennessee,Shelby,14244,18633,2442,4389,1947,0.443609022556391,Top 25th percentile
2502,47163,Tennessee,Sullivan,3739,4373,436,634,198,0.312302839116719,50th-75th percentile
2503,47165,Tennessee,Sumner,2997,3628,489,631,142,0.225039619651347,25th-50th percentile
2504,47167,Tennessee,Tipton,1057,1271,181,214,33,0.154205607476636,25th-50th percentile
2505,47179,Tennessee,Washington,2606,3099,314,493,179,0.363083164300203,50th-75th percentile
2506,47187,Tennessee,Williamson,2503,2760,293,257,-36,-0.140077821011673,Bottom 25th percentile
2507,47189,Tennessee,Wilson,2077,2518,351,441,90,0.204081632653061,25th-50th percentile
2508,48001,Texas,Anderson,1163,1377,204,214,10,0.0467289719626168,25th-50th percentile
2509,48225,Texas,Houston,513,646,92,133,41,0.308270676691729,50th-75th percentile
2510,48005,Texas,Angelina,1603,2111,409,508,99,0.19488188976378,25th-50th percentile
2511,48007,Texas,Aransas,577,750,67,173,106,0.61271676300578,Top 25th percentile
2512,48057,Texas,Calhoun,352,467,37,115,78,0.678260869565217,Top 25th percentile
2513,48391,Texas,Refugio,150,200,30,50,20,0.4,50th-75th percentile
2514,48009,Texas,Archer,158,162,25,4,-21,-5.25,Bottom 25th percentile
2515,48485,Texas,Wichita,2456,2977,517,521,4,0.0076775431861804,25th-50th percentile
2516,48013,Texas,Atascosa,753,1048,218,295,77,0.261016949152542,50th-75th percentile
2517,48297,Texas,Live Oak,221,278,45,57,12,0.210526315789474,25th-50th percentile
2518,48311,Texas,McMullen,20,31,9,11,2,0.181818181818182,25th-50th percentile
2519,48015,Texas,Austin,491,588,58,97,39,0.402061855670103,50th-75th percentile
2520,48473,Texas,Waller,610,791,99,181,82,0.453038674033149,Top 25th percentile
2521,48477,Texas,Washington,667,875,136,208,72,0.346153846153846,50th-75th percentile
2522,48019,Texas,Bandera,461,570,57,109,52,0.477064220183486,Top 25th percentile
2523,48259,Texas,Kendall,726,815,93,89,-4,-0.0449438202247191,Bottom 25th percentile
2524,48265,Texas,Kerr,1315,1454,136,139,3,0.0215827338129496,25th-50th percentile
2525,48021,Texas,Bastrop,1283,1487,185,204,19,0.0931372549019608,25th-50th percentile
2526,48055,Texas,Caldwell,656,851,149,195,46,0.235897435897436,25th-50th percentile
2527,48025,Texas,Bee,484,618,134,134,0,0.0,25th-50th percentile
2528,48175,Texas,Goliad,147,147,23,0,-23,-inf,Bottom 25th percentile
2529,48255,Texas,Karnes,301,325,54,24,-30,-1.25,Bottom 25th percentile
2530,48027,Texas,Bell,4183,5269,723,1086,363,0.334254143646409,50th-75th percentile
2531,48029,Texas,Bexar,24213,30565,5190,6352,1162,0.182934508816121,25th-50th percentile
2532,48493,Texas,Wilson,750,949,147,199,52,0.261306532663317,50th-75th percentile
2533,48035,Texas,Bosque,438,555,53,117,64,0.547008547008547,Top 25th percentile
2534,48193,Texas,Hamilton,244,241,22,-3,-25,8.33333333333333,Top 25th percentile
2535,48217,Texas,Hill,797,1030,169,233,64,0.274678111587983,50th-75th percentile
2536,48037,Texas,Bowie,1879,2285,341,406,65,0.160098522167488,25th-50th percentile
2537,48039,Texas,Brazoria,4323,5417,811,1094,283,0.258683729433272,50th-75th percentile
2538,48041,Texas,Brazos,1883,2363,353,480,127,0.264583333333333,50th-75th percentile
2539,48051,Texas,Burleson,419,467,60,48,-12,-0.25,Bottom 25th percentile
2540,48185,Texas,Grimes,515,661,108,146,38,0.26027397260274,50th-75th percentile
2541,48395,Texas,Robertson,342,437,68,95,27,0.284210526315789,50th-75th percentile
2542,48049,Texas,Brown,899,1164,171,265,94,0.354716981132075,50th-75th percentile
2543,48083,Texas,Coleman,245,319,53,74,21,0.283783783783784,50th-75th percentile
2544,48333,Texas,Mills,128,150,28,22,-6,-0.272727272727273,Bottom 25th percentile
2545,48053,Texas,Burnet,974,1112,135,138,3,0.0217391304347826,25th-50th percentile
2546,48281,Texas,Lampasas,405,538,65,133,68,0.511278195488722,Top 25th percentile
2547,48299,Texas,Llano,598,671,75,73,-2,-0.0273972602739726,25th-50th percentile
2548,48059,Texas,Callahan,316,393,57,77,20,0.25974025974026,50th-75th percentile
2549,48133,Texas,Eastland,452,559,77,107,30,0.280373831775701,50th-75th percentile
2550,48253,Texas,Jones,317,455,95,138,43,0.311594202898551,50th-75th percentile
2551,48417,Texas,Shackelford,53,72,14,19,5,0.263157894736842,50th-75th percentile
2552,48429,Texas,Stephens,188,254,39,66,27,0.409090909090909,50th-75th percentile
2553,48061,Texas,Cameron,5052,7225,1773,2173,400,0.184077312471238,25th-50th percentile
2554,48067,Texas,Cass,721,985,162,264,102,0.386363636363636,50th-75th percentile
2555,48315,Texas,Marion,308,350,58,42,-16,-0.380952380952381,Bottom 25th percentile
2556,48343,Texas,Morris,341,374,56,33,-23,-0.696969696969697,Bottom 25th percentile
2557,48071,Texas,Chambers,538,687,110,149,39,0.261744966442953,50th-75th percentile
2558,48291,Texas,Liberty,1505,1748,316,243,-73,-0.300411522633745,Bottom 25th percentile
2559,48073,Texas,Cherokee,989,1294,241,305,64,0.209836065573771,25th-50th percentile
2560,48077,Texas,Clay,223,256,28,33,5,0.151515151515152,25th-50th percentile
2561,48097,Texas,Cooke,757,878,114,121,7,0.0578512396694215,25th-50th percentile
2562,48337,Texas,Montague,505,629,89,124,35,0.282258064516129,50th-75th percentile
2563,48085,Texas,Collin,8676,10142,1174,1466,292,0.199181446111869,25th-50th percentile
2564,48091,Texas,Comal,2497,2946,401,449,48,0.106904231625835,25th-50th percentile
2565,48093,Texas,Comanche,325,410,67,85,18,0.211764705882353,25th-50th percentile
2566,48143,Texas,Erath,585,711,108,126,18,0.142857142857143,25th-50th percentile
2567,48425,Texas,Somervell,163,210,17,47,30,0.638297872340426,Top 25th percentile
2568,48099,Texas,Coryell,883,1152,164,269,105,0.390334572490706,50th-75th percentile
2569,48105,Texas,Crockett,69,99,16,30,14,0.466666666666667,Top 25th percentile
2570,48271,Texas,Kinney,72,85,6,13,7,0.538461538461538,Top 25th percentile
2571,48443,Texas,Terrell,22,30,7,8,1,0.125,25th-50th percentile
2572,48465,Texas,Val Verde,706,947,254,241,-13,-0.053941908713693,Bottom 25th percentile
2573,48107,Texas,Crosby,122,164,39,42,3,0.0714285714285714,25th-50th percentile
2574,48153,Texas,Floyd,111,177,39,66,27,0.409090909090909,50th-75th percentile
2575,48189,Texas,Hale,554,729,187,175,-12,-0.0685714285714286,Bottom 25th percentile
2576,48437,Texas,Swisher,150,176,19,26,7,0.269230769230769,50th-75th percentile
2577,48113,Texas,Dallas,28523,34457,5416,5934,518,0.087293562521065,25th-50th percentile
2578,48121,Texas,Denton,7348,8678,1029,1330,301,0.226315789473684,25th-50th percentile
2579,48127,Texas,Dimmit,159,231,47,72,25,0.347222222222222,50th-75th percentile
2580,48283,Texas,La Salle,100,139,41,39,-2,-0.0512820512820513,Bottom 25th percentile
2581,48323,Texas,Maverick,726,1181,408,455,47,0.103296703296703,25th-50th percentile
2582,48047,Texas,Brooks,139,187,47,48,1,0.0208333333333333,25th-50th percentile
2583,48131,Texas,Duval,223,275,52,52,0,0.0,25th-50th percentile
2584,48247,Texas,Jim Hogg,88,117,16,29,13,0.448275862068966,Top 25th percentile
2585,48249,Texas,Jim Wells,711,951,174,240,66,0.275,50th-75th percentile
2586,48505,Texas,Zapata,173,237,45,64,19,0.296875,50th-75th percentile
2587,48011,Texas,Armstrong,58,60,11,2,-9,-4.5,Bottom 25th percentile
2588,48023,Texas,Baylor,109,133,23,24,1,0.0416666666666667,25th-50th percentile
2589,48045,Texas,Briscoe,32,35,8,3,-5,-1.66666666666667,Bottom 25th percentile
2590,48075,Texas,Childress,132,142,23,10,-13,-1.3,Bottom 25th percentile
2591,48101,Texas,Cottle,42,51,14,9,-5,-0.555555555555556,Bottom 25th percentile
2592,48125,Texas,Dickens,45,62,11,17,6,0.352941176470588,50th-75th percentile
2593,48129,Texas,Donley,83,105,15,22,7,0.318181818181818,50th-75th percentile
2594,48155,Texas,Foard,35,50,7,15,8,0.533333333333333,Top 25th percentile
2595,48191,Texas,Hall,76,89,12,13,1,0.0769230769230769,25th-50th percentile
2596,48197,Texas,Hardeman,81,110,14,29,15,0.517241379310345,Top 25th percentile
2597,48207,Texas,Haskell,125,168,29,43,14,0.325581395348837,50th-75th percentile
2598,48269,Texas,King,9,12,12,3,-9,-3.0,Bottom 25th percentile
2599,48275,Texas,Knox,92,120,20,28,8,0.285714285714286,50th-75th percentile
2600,48345,Texas,Motley,37,43,7,6,-1,-0.166666666666667,Bottom 25th percentile
2601,48433,Texas,Stonewall,42,44,12,2,-10,-5.0,Bottom 25th percentile
2602,48447,Texas,Throckmorton,37,37,14,0,-14,-inf,Bottom 25th percentile
2603,48487,Texas,Wilbarger,303,353,61,50,-11,-0.22,Bottom 25th percentile
2604,48135,Texas,Ector,2160,2709,545,549,4,0.0072859744990892,25th-50th percentile
2605,48139,Texas,Ellis,2455,3041,447,586,139,0.237201365187713,25th-50th percentile
2606,48141,Texas,El Paso,9737,13403,2892,3666,774,0.211129296235679,25th-50th percentile
2607,48145,Texas,Falls,335,377,56,42,-14,-0.333333333333333,Bottom 25th percentile
2608,48287,Texas,Lee,343,375,55,32,-23,-0.71875,Bottom 25th percentile
2609,48331,Texas,Milam,506,607,89,101,12,0.118811881188119,25th-50th percentile
2610,48147,Texas,Fannin,814,948,162,134,-28,-0.208955223880597,Bottom 25th percentile
2611,48277,Texas,Lamar,1111,1405,210,294,84,0.285714285714286,50th-75th percentile
2612,48387,Texas,Red River,342,419,53,77,24,0.311688311688312,50th-75th percentile
2613,48157,Texas,Fort Bend,6510,8034,1013,1524,511,0.335301837270341,50th-75th percentile
2614,48161,Texas,Freestone,394,450,72,56,-16,-0.285714285714286,Bottom 25th percentile
2615,48289,Texas,Leon,386,458,58,72,14,0.194444444444444,25th-50th percentile
2616,48293,Texas,Limestone,498,653,104,155,51,0.329032258064516,50th-75th percentile
2617,48349,Texas,Navarro,1014,1129,200,115,-85,-0.739130434782609,Bottom 25th percentile
2618,48163,Texas,Frio,305,354,73,49,-24,-0.489795918367347,Bottom 25th percentile
2619,48325,Texas,Medina,823,960,168,137,-31,-0.226277372262774,Bottom 25th percentile
2620,48463,Texas,Uvalde,456,591,109,135,26,0.192592592592593,25th-50th percentile
2621,48507,Texas,Zavala,194,266,52,72,20,0.277777777777778,50th-75th percentile
2622,48003,Texas,Andrews,234,264,62,30,-32,-1.06666666666667,Bottom 25th percentile
2623,48115,Texas,Dawson,270,316,80,46,-34,-0.739130434782609,Bottom 25th percentile
2624,48165,Texas,Gaines,223,285,65,62,-3,-0.0483870967741936,Bottom 25th percentile
2625,48305,Texas,Lynn,117,153,29,36,7,0.194444444444444,25th-50th percentile
2626,48317,Texas,Martin,89,98,19,9,-10,-1.11111111111111,Bottom 25th percentile
2627,48445,Texas,Terry,228,270,64,42,-22,-0.523809523809524,Bottom 25th percentile
2628,48501,Texas,Yoakum,108,147,33,39,6,0.153846153846154,25th-50th percentile
2629,48167,Texas,Galveston,5026,6023,661,997,336,0.337011033099298,50th-75th percentile
2630,48181,Texas,Grayson,2715,3260,488,545,57,0.104587155963303,25th-50th percentile
2631,48183,Texas,Gregg,2344,3005,483,661,178,0.26928895612708,50th-75th percentile
2632,48187,Texas,Guadalupe,2117,2578,359,461,102,0.221258134490239,25th-50th percentile
2633,48199,Texas,Hardin,1066,1278,209,212,3,0.0141509433962264,25th-50th percentile
2634,48201,Texas,Harris,46459,58201,9356,11742,2386,0.203202180207801,25th-50th percentile
2635,48203,Texas,Harrison,1150,1486,232,336,104,0.30952380952381,50th-75th percentile
2636,48459,Texas,Upshur,851,1050,173,199,26,0.130653266331658,25th-50th percentile
2637,48209,Texas,Hays,2186,2535,330,349,19,0.0544412607449857,25th-50th percentile
2638,48213,Texas,Henderson,1986,2510,371,524,153,0.291984732824428,50th-75th percentile
2639,48215,Texas,Hidalgo,8374,12268,3150,3894,744,0.191063174114022,25th-50th percentile
2640,48221,Texas,Hood,1369,1605,188,236,48,0.203389830508475,25th-50th percentile
2641,48063,Texas,Camp,301,373,62,72,10,0.138888888888889,25th-50th percentile
2642,48119,Texas,Delta,125,158,17,33,16,0.484848484848485,Top 25th percentile
2643,48159,Texas,Franklin,218,234,35,16,-19,-1.1875,Bottom 25th percentile
2644,48223,Texas,Hopkins,733,903,148,170,22,0.129411764705882,25th-50th percentile
2645,48449,Texas,Titus,537,594,112,57,-55,-0.964912280701754,Bottom 25th percentile
2646,48499,Texas,Wood,1163,1443,215,280,65,0.232142857142857,25th-50th percentile
2647,48231,Texas,Hunt,1761,2121,324,360,36,0.1,25th-50th percentile
2648,48237,Texas,Jack,167,183,16,16,0,0.0,25th-50th percentile
2649,48363,Texas,Palo Pinto,595,786,119,191,72,0.37696335078534,50th-75th percentile
2650,48503,Texas,Young,435,561,65,126,61,0.484126984126984,Top 25th percentile
2651,48239,Texas,Jackson,306,313,50,7,-43,-6.14285714285714,Bottom 25th percentile
2652,48321,Texas,Matagorda,705,804,157,99,-58,-0.585858585858586,Bottom 25th percentile
2653,48481,Texas,Wharton,760,951,188,191,3,0.0157068062827225,25th-50th percentile
2654,48241,Texas,Jasper,753,988,167,235,68,0.28936170212766,50th-75th percentile
2655,48351,Texas,Newton,287,384,63,97,34,0.350515463917526,50th-75th percentile
2656,48245,Texas,Jefferson,4288,5366,721,1078,357,0.331168831168831,50th-75th percentile
2657,48251,Texas,Johnson,2702,3355,515,653,138,0.211332312404288,25th-50th percentile
2658,48257,Texas,Kaufman,1973,2341,373,368,-5,-0.0135869565217391,25th-50th percentile
2659,48261,Texas,Kenedy,7,10,10,3,-7,-2.33333333333333,Bottom 25th percentile
2660,48273,Texas,Kleberg,502,618,130,116,-14,-0.120689655172414,Bottom 25th percentile
2661,48489,Texas,Willacy,340,429,108,89,-19,-0.213483146067416,Bottom 25th percentile
2662,48089,Texas,Colorado,456,545,54,89,35,0.393258426966292,50th-75th percentile
2663,48123,Texas,DeWitt,468,519,85,51,-34,-0.666666666666667,Bottom 25th percentile
2664,48149,Texas,Fayette,562,665,90,103,13,0.12621359223301,25th-50th percentile
2665,48177,Texas,Gonzales,377,457,84,80,-4,-0.05,Bottom 25th percentile
2666,48285,Texas,Lavaca,461,549,85,88,3,0.0340909090909091,25th-50th percentile
2667,48303,Texas,Lubbock,4508,5744,1035,1236,201,0.162621359223301,25th-50th percentile
2668,48309,Texas,McLennan,3957,4937,731,980,249,0.254081632653061,50th-75th percentile
2669,48313,Texas,Madison,251,297,49,46,-3,-0.0652173913043478,Bottom 25th percentile
2670,48455,Texas,Trinity,434,507,59,73,14,0.191780821917808,25th-50th percentile
2671,48471,Texas,Walker,961,1218,192,257,65,0.252918287937743,50th-75th percentile
2672,48031,Texas,Blanco,240,245,29,5,-24,-4.8,Bottom 25th percentile
2673,48081,Texas,Coke,98,119,17,21,4,0.19047619047619,25th-50th percentile
2674,48095,Texas,Concho,52,62,11,10,-1,-0.1,Bottom 25th percentile
2675,48137,Texas,Edwards,47,58,8,11,3,0.272727272727273,50th-75th percentile
2676,48171,Texas,Gillespie,641,707,79,66,-13,-0.196969696969697,Bottom 25th percentile
2677,48173,Texas,Glasscock,31,16,8,-15,-23,1.53333333333333,Top 25th percentile
2678,48235,Texas,Irion,25,39,7,14,7,0.5,Top 25th percentile
2679,48267,Texas,Kimble,105,107,5,2,-3,-1.5,Bottom 25th percentile
2680,48307,Texas,McCulloch,191,252,37,61,24,0.39344262295082,50th-75th percentile
2681,48319,Texas,Mason,92,97,12,5,-7,-1.4,Bottom 25th percentile
2682,48327,Texas,Menard,63,68,12,5,-7,-1.4,Bottom 25th percentile
2683,48383,Texas,Reagan,51,53,12,2,-10,-5.0,Bottom 25th percentile
2684,48385,Texas,Real,91,115,22,24,2,0.0833333333333333,25th-50th percentile
2685,48399,Texas,Runnels,288,310,54,22,-32,-1.45454545454545,Bottom 25th percentile
2686,48411,Texas,San Saba,129,166,28,37,9,0.243243243243243,50th-75th percentile
2687,48413,Texas,Schleicher,48,52,10,4,-6,-1.5,Bottom 25th percentile
2688,48431,Texas,Sterling,25,29,10,4,-6,-1.5,Bottom 25th percentile
2689,48435,Texas,Sutton,57,88,7,31,24,0.774193548387097,Top 25th percentile
2690,48329,Texas,Midland,2048,2254,387,206,-181,-0.878640776699029,Bottom 25th percentile
2691,48339,Texas,Montgomery,7270,8609,1090,1339,249,0.185959671396565,25th-50th percentile
2692,48347,Texas,Nacogdoches,1002,1343,224,341,117,0.343108504398827,50th-75th percentile
2693,48087,Texas,Collingsworth,67,78,12,11,-1,-0.0909090909090909,Bottom 25th percentile
2694,48179,Texas,Gray,463,518,82,55,-27,-0.490909090909091,Bottom 25th percentile
2695,48195,Texas,Hansford,83,95,27,12,-15,-1.25,Bottom 25th percentile
2696,48211,Texas,Hemphill,58,43,10,-15,-25,1.66666666666667,Top 25th percentile
2697,48295,Texas,Lipscomb,46,62,4,16,12,0.75,Top 25th percentile
2698,48357,Texas,Ochiltree,125,165,42,40,-2,-0.05,Bottom 25th percentile
2699,48393,Texas,Roberts,19,11,2,-8,-10,1.25,Top 25th percentile
2700,48483,Texas,Wheeler,107,140,16,33,17,0.515151515151515,Top 25th percentile
2701,48065,Texas,Carson,101,151,23,50,27,0.54,Top 25th percentile
2702,48111,Texas,Dallam,70,123,16,53,37,0.69811320754717,Top 25th percentile
2703,48205,Texas,Hartley,74,78,15,4,-11,-2.75,Bottom 25th percentile
2704,48233,Texas,Hutchinson,435,541,92,106,14,0.132075471698113,25th-50th percentile
2705,48341,Texas,Moore,292,320,90,28,-62,-2.21428571428571,Bottom 25th percentile
2706,48359,Texas,Oldham,29,32,3,3,0,0.0,25th-50th percentile
2707,48421,Texas,Sherman,46,45,19,-1,-20,20.0,Top 25th percentile
2708,48355,Texas,Nueces,5159,6785,1113,1626,513,0.31549815498155,50th-75th percentile
2709,48361,Texas,Orange,1692,2053,300,361,61,0.168975069252078,25th-50th percentile
2710,48365,Texas,Panola,485,676,115,191,76,0.397905759162304,50th-75th percentile
2711,48403,Texas,Sabine,315,387,64,72,8,0.111111111111111,25th-50th percentile
2712,48405,Texas,San Augustine,224,321,39,97,58,0.597938144329897,Top 25th percentile
2713,48419,Texas,Shelby,509,619,114,110,-4,-0.0363636363636364,25th-50th percentile
2714,48367,Texas,Parker,2220,2577,364,357,-7,-0.0196078431372549,25th-50th percentile
2715,48373,Texas,Polk,1224,1534,216,310,94,0.303225806451613,50th-75th percentile
2716,48407,Texas,San Jacinto,579,746,99,167,68,0.407185628742515,50th-75th percentile
2717,48457,Texas,Tyler,475,623,74,148,74,0.5,Top 25th percentile
2718,48375,Texas,Potter,2083,2700,490,617,127,0.205834683954619,25th-50th percentile
2719,48379,Texas,Rains,319,342,50,23,-27,-1.17391304347826,Bottom 25th percentile
2720,48467,Texas,Van Zandt,1176,1567,226,391,165,0.421994884910486,Top 25th percentile
2721,48381,Texas,Randall,1928,2420,373,492,119,0.241869918699187,50th-75th percentile
2722,48397,Texas,Rockwall,1216,1401,210,185,-25,-0.135135135135135,Bottom 25th percentile
2723,48401,Texas,Rusk,952,1284,224,332,108,0.325301204819277,50th-75th percentile
2724,48409,Texas,San Patricio,1121,1470,286,349,63,0.180515759312321,25th-50th percentile
2725,48033,Texas,Borden,18,10,10,-8,-18,2.25,Top 25th percentile
2726,48151,Texas,Fisher,76,125,22,49,27,0.551020408163265,Top 25th percentile
2727,48169,Texas,Garza,84,110,16,26,10,0.384615384615385,50th-75th percentile
2728,48227,Texas,Howard,650,799,143,149,6,0.0402684563758389,25th-50th percentile
2729,48263,Texas,Kent,26,34,10,8,-2,-0.25,Bottom 25th percentile
2730,48335,Texas,Mitchell,160,168,39,8,-31,-3.875,Bottom 25th percentile
2731,48353,Texas,Nolan,340,390,77,50,-27,-0.54,Bottom 25th percentile
2732,48415,Texas,Scurry,313,371,81,58,-23,-0.396551724137931,Bottom 25th percentile
2733,48423,Texas,Smith,3848,4977,787,1129,342,0.302922940655447,50th-75th percentile
2734,48427,Texas,Starr,782,1227,332,445,113,0.253932584269663,50th-75th percentile
2735,48439,Texas,Tarrant,23845,29146,4428,5301,873,0.164685908319185,25th-50th percentile
2736,48441,Texas,Taylor,2477,2955,542,478,-64,-0.133891213389121,Bottom 25th percentile
2737,48451,Texas,Tom Green,1929,2539,390,610,220,0.360655737704918,50th-75th percentile
2738,48453,Texas,Travis,10220,11823,1409,1603,194,0.121023081721772,25th-50th percentile
2739,48469,Texas,Victoria,1470,1904,352,434,82,0.188940092165899,25th-50th percentile
2740,48479,Texas,Webb,2558,3716,928,1158,230,0.198618307426598,25th-50th percentile
2741,48017,Texas,Bailey,93,132,28,39,11,0.282051282051282,50th-75th percentile
2742,48069,Texas,Castro,104,147,36,43,7,0.162790697674419,25th-50th percentile
2743,48079,Texas,Cochran,46,68,12,22,10,0.454545454545455,Top 25th percentile
2744,48117,Texas,Deaf Smith,283,344,86,61,-25,-0.409836065573771,Bottom 25th percentile
2745,48219,Texas,Hockley,380,526,138,146,8,0.0547945205479452,25th-50th percentile
2746,48279,Texas,Lamb,299,339,83,40,-43,-1.075,Bottom 25th percentile
2747,48369,Texas,Parmer,126,191,39,65,26,0.4,50th-75th percentile
2748,48043,Texas,Brewster,146,181,23,35,12,0.342857142857143,50th-75th percentile
2749,48103,Texas,Crane,65,85,11,20,9,0.45,Top 25th percentile
2750,48109,Texas,Culberson,34,57,7,23,16,0.695652173913044,Top 25th percentile
2751,48229,Texas,Hudspeth,52,62,11,10,-1,-0.1,Bottom 25th percentile
2752,48243,Texas,Jeff Davis,37,46,8,9,1,0.111111111111111,25th-50th percentile
2753,48301,Texas,Loving,4,12,12,8,-4,-0.5,Bottom 25th percentile
2754,48371,Texas,Pecos,220,327,55,107,52,0.485981308411215,Top 25th percentile
2755,48377,Texas,Presidio,80,118,28,38,10,0.263157894736842,50th-75th percentile
2756,48389,Texas,Reeves,206,269,55,63,8,0.126984126984127,25th-50th percentile
2757,48461,Texas,Upton,56,66,10,10,0,0.0,25th-50th percentile
2758,48475,Texas,Ward,210,212,32,2,-30,-15.0,Bottom 25th percentile
2759,48495,Texas,Winkler,121,137,31,16,-15,-0.9375,Bottom 25th percentile
2760,48491,Texas,Williamson,5736,6608,777,872,95,0.10894495412844,25th-50th percentile
2761,48497,Texas,Wise,1139,1404,214,265,51,0.192452830188679,25th-50th percentile
2762,49001,Utah,Beaver,102,108,16,6,-10,-1.66666666666667,Bottom 25th percentile
2763,49021,Utah,Iron,599,702,65,103,38,0.368932038834951,50th-75th percentile
2764,49027,Utah,Millard,173,244,31,71,40,0.563380281690141,Top 25th percentile
2765,49003,Utah,Box Elder,698,841,92,143,51,0.356643356643357,50th-75th percentile
2766,49005,Utah,Cache,1027,1142,72,115,43,0.373913043478261,50th-75th percentile
2767,49033,Utah,Rich,31,27,7,-4,-11,2.75,Top 25th percentile
2768,49007,Utah,Carbon,388,465,26,77,51,0.662337662337662,Top 25th percentile
2769,49009,Utah,Daggett,21,8,8,-13,-21,1.61538461538462,Top 25th percentile
2770,49013,Utah,Duchesne,240,291,13,51,38,0.745098039215686,Top 25th percentile
2771,49047,Utah,Uintah,417,534,52,117,65,0.555555555555556,Top 25th percentile
2772,49011,Utah,Davis,3266,3781,257,515,258,0.500970873786408,Top 25th percentile
2773,49023,Utah,Juab,124,146,10,22,12,0.545454545454545,Top 25th percentile
2774,49039,Utah,Sanpete,362,418,41,56,15,0.267857142857143,50th-75th percentile
2775,49045,Utah,Tooele,690,743,67,53,-14,-0.264150943396226,Bottom 25th percentile
2776,49029,Utah,Morgan,118,117,10,-1,-11,11.0,Top 25th percentile
2777,49043,Utah,Summit,291,292,18,1,-17,-17.0,Bottom 25th percentile
2778,49051,Utah,Wasatch,292,308,23,16,-7,-0.4375,Bottom 25th percentile
2779,49035,Utah,Salt Lake,11602,12891,1035,1289,254,0.197051978277735,25th-50th percentile
2780,49049,Utah,Utah (county),4710,5197,508,487,-21,-0.0431211498973306,25th-50th percentile
2781,49053,Utah,Washington,2627,3005,290,378,88,0.232804232804233,25th-50th percentile
2782,49015,Utah,Emery,163,196,21,33,12,0.363636363636364,50th-75th percentile
2783,49017,Utah,Garfield,82,103,7,21,14,0.666666666666667,Top 25th percentile
2784,49019,Utah,Grand,149,131,11,-18,-29,1.61111111111111,Top 25th percentile
2785,49025,Utah,Kane,135,146,16,11,-5,-0.454545454545455,Bottom 25th percentile
2786,49031,Utah,Piute,30,30,3,0,-3,-inf,Bottom 25th percentile
2787,49037,Utah,San Juan,186,255,64,69,5,0.072463768115942,25th-50th percentile
2788,49041,Utah,Sevier,366,381,12,15,3,0.2,25th-50th percentile
2789,49055,Utah,Wayne,44,58,3,14,11,0.785714285714286,Top 25th percentile
2790,49057,Utah,Weber,3137,3482,267,345,78,0.226086956521739,25th-50th percentile
2791,50001,Vermont,Addison,553,587,10,34,24,0.705882352941177,Top 25th percentile
2792,50007,Vermont,Chittenden,1991,2119,95,128,33,0.2578125,50th-75th percentile
2793,50003,Vermont,Bennington,797,869,18,72,54,0.75,Top 25th percentile
2794,50025,Vermont,Windham,757,824,22,67,45,0.671641791044776,Top 25th percentile
2795,50005,Vermont,Caledonia,531,592,13,61,48,0.786885245901639,Top 25th percentile
2796,50009,Vermont,Essex,126,139,11,13,2,0.153846153846154,25th-50th percentile
2797,50017,Vermont,Orange,478,488,10,10,0,0.0,25th-50th percentile
2798,50011,Vermont,Franklin,758,807,44,49,5,0.102040816326531,25th-50th percentile
2799,50013,Vermont,Grand Isle,102,131,9,29,20,0.689655172413793,Top 25th percentile
2800,50015,Vermont,Lamoille,366,403,11,37,26,0.702702702702703,Top 25th percentile
2801,50019,Vermont,Orleans,549,627,18,78,60,0.769230769230769,Top 25th percentile
2802,50021,Vermont,Rutland,1190,1310,21,120,99,0.825,Top 25th percentile
2803,50023,Vermont,Washington,937,1037,16,100,84,0.84,Top 25th percentile
2804,50027,Vermont,Windsor,1001,1063,25,62,37,0.596774193548387,Top 25th percentile
2805,51001,Virginia,Accomack,760,905,78,145,67,0.462068965517241,Top 25th percentile
2806,51131,Virginia,Northampton,331,387,38,56,18,0.321428571428571,50th-75th percentile
2807,51810,Virginia,Virginia Beach (city),5668,6510,516,842,326,0.387173396674584,50th-75th percentile
2808,51003,Virginia,Albemarle,1511,1698,114,187,73,0.390374331550802,50th-75th percentile
2809,51540,Virginia,Charlottesville (city),502,529,44,27,-17,-0.62962962962963,Bottom 25th percentile
2810,51510,Virginia,Alexandria (city),1301,1385,141,84,-57,-0.678571428571429,Bottom 25th percentile
2811,51005,Virginia,Alleghany,377,499,67,122,55,0.450819672131148,Top 25th percentile
2812,51017,Virginia,Bath,115,136,13,21,8,0.380952380952381,50th-75th percentile
2813,51023,Virginia,Botetourt,625,729,57,104,47,0.451923076923077,Top 25th percentile
2814,51091,Virginia,Highland,51,51,10,0,-10,-inf,Bottom 25th percentile
2815,51580,Virginia,Covington (city),198,185,22,-13,-35,2.69230769230769,Top 25th percentile
2816,51007,Virginia,Amelia,290,340,26,50,24,0.48,Top 25th percentile
2817,51025,Virginia,Brunswick,375,423,36,48,12,0.25,50th-75th percentile
2818,51111,Virginia,Lunenburg,293,287,18,-6,-24,4.0,Top 25th percentile
2819,51135,Virginia,Nottoway,367,411,48,44,-4,-0.0909090909090909,Bottom 25th percentile
2820,51009,Virginia,Amherst,611,707,62,96,34,0.354166666666667,50th-75th percentile
2821,51125,Virginia,Nelson,337,347,21,10,-11,-1.1,Bottom 25th percentile
2822,51680,Virginia,Lynchburg (city),1425,1586,147,161,14,0.0869565217391304,25th-50th percentile
2823,51011,Virginia,Appomattox,341,331,26,-10,-36,3.6,Top 25th percentile
2824,51031,Virginia,Campbell,1002,1236,137,234,97,0.414529914529915,Top 25th percentile
2825,51013,Virginia,Arlington,1647,1886,219,239,20,0.0836820083682008,25th-50th percentile
2826,51015,Virginia,Augusta,1220,1541,136,321,185,0.576323987538941,Top 25th percentile
2827,51163,Virginia,Rockbridge,446,564,72,118,46,0.389830508474576,50th-75th percentile
2828,51530,Virginia,Buena Vista (city),141,181,22,40,18,0.45,Top 25th percentile
2829,51678,Virginia,Lexington (city),155,138,15,-17,-32,1.88235294117647,Top 25th percentile
2830,51790,Virginia,Staunton (city),677,713,74,36,-38,-1.05555555555556,Bottom 25th percentile
2831,51820,Virginia,Waynesboro (city),496,506,37,10,-27,-2.7,Bottom 25th percentile
2832,51019,Virginia,Bedford (county),1444,1697,144,253,109,0.430830039525692,Top 25th percentile
2833,51021,Virginia,Bland,144,163,13,19,6,0.315789473684211,50th-75th percentile
2834,51173,Virginia,Smyth,791,956,102,165,63,0.381818181818182,50th-75th percentile
2835,51197,Virginia,Wythe,718,849,101,131,30,0.229007633587786,25th-50th percentile
2836,51191,Virginia,Washington,1101,1475,154,374,220,0.588235294117647,Top 25th percentile
2837,51520,Virginia,Bristol (city),485,513,54,28,-26,-0.928571428571429,Bottom 25th percentile
2838,51027,Virginia,Buchanan,528,646,69,118,49,0.415254237288136,Top 25th percentile
2839,51051,Virginia,Dickenson,368,386,34,18,-16,-0.888888888888889,Bottom 25th percentile
2840,51167,Virginia,Russell,634,750,70,116,46,0.396551724137931,50th-75th percentile
2841,51185,Virginia,Tazewell,1048,1252,109,204,95,0.465686274509804,Top 25th percentile
2842,51035,Virginia,Carroll,650,855,106,205,99,0.482926829268293,Top 25th percentile
2843,51077,Virginia,Grayson,364,453,54,89,35,0.393258426966292,50th-75th percentile
2844,51640,Virginia,Galax (city),284,258,38,-26,-64,2.46153846153846,Top 25th percentile
2845,51036,Virginia,Charles City,147,189,14,42,28,0.666666666666667,Top 25th percentile
2846,51075,Virginia,Goochland,387,437,40,50,10,0.2,25th-50th percentile
2847,51087,Virginia,Henrico,5059,6070,607,1011,404,0.399604352126607,50th-75th percentile
2848,51127,Virginia,New Kent,356,388,30,32,2,0.0625,25th-50th percentile
2849,51550,Virginia,Chesapeake (city),3285,3928,352,643,291,0.452566096423017,Top 25th percentile
2850,51041,Virginia,Chesterfield,4528,5305,496,777,281,0.361647361647362,50th-75th percentile
2851,51145,Virginia,Powhatan,397,513,33,116,83,0.71551724137931,Top 25th percentile
2852,51570,Virginia,Colonial Heights (city),443,519,46,76,30,0.394736842105263,50th-75th percentile
2853,51043,Virginia,Clarke,297,322,23,25,2,0.08,25th-50th percentile
2854,51187,Virginia,Warren,679,793,81,114,33,0.289473684210526,50th-75th percentile
2855,51045,Virginia,Craig,97,116,14,19,5,0.263157894736842,50th-75th percentile
2856,51067,Virginia,Franklin (county),1039,1258,102,219,117,0.534246575342466,Top 25th percentile
2857,51161,Virginia,Roanoke (county),1774,2123,176,349,173,0.495702005730659,Top 25th percentile
2858,51775,Virginia,Salem (city),621,700,58,79,21,0.265822784810127,50th-75th percentile
2859,51047,Virginia,Culpeper,790,861,75,71,-4,-0.0563380281690141,Bottom 25th percentile
2860,51113,Virginia,Madison,256,272,29,16,-13,-0.8125,Bottom 25th percentile
2861,51157,Virginia,Rappahannock,118,131,8,13,5,0.384615384615385,50th-75th percentile
2862,51143,Virginia,Pittsylvania,1241,1470,142,229,87,0.379912663755459,50th-75th percentile
2863,51590,Virginia,Danville (city),1187,1425,167,238,71,0.298319327731092,50th-75th percentile
2864,51053,Virginia,Dinwiddie,483,585,54,102,48,0.470588235294118,Top 25th percentile
2865,51730,Virginia,Petersburg (city),909,1044,97,135,38,0.281481481481482,50th-75th percentile
2866,51059,Virginia,Fairfax (county),9602,10613,1066,1011,-55,-0.0544015825914936,Bottom 25th percentile
2867,51600,Virginia,Fairfax (city),442,411,33,-31,-64,2.06451612903226,Top 25th percentile
2868,51610,Virginia,Falls Church (city),172,156,13,-16,-29,1.8125,Top 25th percentile
2869,51061,Virginia,Fauquier,979,1095,68,116,48,0.413793103448276,Top 25th percentile
2870,51063,Virginia,Floyd,309,375,24,66,42,0.636363636363636,Top 25th percentile
2871,51071,Virginia,Giles,412,503,35,91,56,0.615384615384615,Top 25th percentile
2872,51121,Virginia,Montgomery,1143,1280,117,137,20,0.145985401459854,25th-50th percentile
2873,51069,Virginia,Frederick,1335,1620,153,285,132,0.463157894736842,Top 25th percentile
2874,51840,Virginia,Winchester (city),450,546,57,96,39,0.40625,50th-75th percentile
2875,51177,Virginia,Spotsylvania,1680,1945,157,265,108,0.407547169811321,50th-75th percentile
2876,51630,Virginia,Fredericksburg (city),376,395,3,19,16,0.842105263157895,Top 25th percentile
2877,51079,Virginia,Greene,304,362,39,58,19,0.327586206896552,50th-75th percentile
2878,51109,Virginia,Louisa,631,736,44,105,61,0.580952380952381,Top 25th percentile
2879,51137,Virginia,Orange,727,769,52,42,-10,-0.238095238095238,Bottom 25th percentile
2880,51083,Virginia,Halifax,832,1001,120,169,49,0.289940828402367,50th-75th percentile
2881,51117,Virginia,Mecklenburg,820,913,90,93,3,0.032258064516129,25th-50th percentile
2882,51650,Virginia,Hampton (city),2222,2611,236,389,153,0.393316195372751,50th-75th percentile
2883,51735,Virginia,Poquoson (city),220,228,15,8,-7,-0.875,Bottom 25th percentile
2884,51085,Virginia,Hanover,1701,2035,165,334,169,0.505988023952096,Top 25th percentile
2885,51165,Virginia,Rockingham,1299,1627,187,328,141,0.429878048780488,Top 25th percentile
2886,51660,Virginia,Harrisonburg (city),558,614,71,56,-15,-0.267857142857143,Bottom 25th percentile
2887,51089,Virginia,Henry,1157,1511,185,354,169,0.477401129943503,Top 25th percentile
2888,51141,Virginia,Patrick,451,552,69,101,32,0.316831683168317,50th-75th percentile
2889,51690,Virginia,Martinsville (city),530,498,75,-32,-107,3.34375,Top 25th percentile
2890,51149,Virginia,Prince George,431,533,49,102,53,0.519607843137255,Top 25th percentile
2891,51670,Virginia,Hopewell (city),529,622,69,93,24,0.258064516129032,50th-75th percentile
2892,51095,Virginia,James City,1412,1599,87,187,100,0.53475935828877,Top 25th percentile
2893,51830,Virginia,Williamsburg (city),140,152,7,12,5,0.416666666666667,Top 25th percentile
2894,51033,Virginia,Caroline,500,595,56,95,39,0.410526315789474,50th-75th percentile
2895,51057,Virginia,Essex,240,293,20,53,33,0.622641509433962,Top 25th percentile
2896,51073,Virginia,Gloucester,717,870,63,153,90,0.588235294117647,Top 25th percentile
2897,51097,Virginia,King and Queen,163,160,10,-3,-13,4.33333333333333,Top 25th percentile
2898,51101,Virginia,King William,307,339,21,32,11,0.34375,50th-75th percentile
2899,51115,Virginia,Mathews,230,278,25,48,23,0.479166666666667,Top 25th percentile
2900,51119,Virginia,Middlesex,299,335,26,36,10,0.277777777777778,50th-75th percentile
2901,51105,Virginia,Lee,523,693,80,170,90,0.529411764705882,Top 25th percentile
2902,51169,Virginia,Scott,567,660,78,93,15,0.161290322580645,25th-50th percentile
2903,51195,Virginia,Wise,863,1041,96,178,82,0.460674157303371,Top 25th percentile
2904,51720,Virginia,Norton (city),95,142,14,47,33,0.702127659574468,Top 25th percentile
2905,51107,Virginia,Loudoun,2747,3119,279,372,93,0.25,50th-75th percentile
2906,51683,Virginia,Manassas (city),437,483,71,46,-25,-0.543478260869565,Bottom 25th percentile
2907,51685,Virginia,Manassas Park (city),78,72,13,-6,-19,3.16666666666667,Top 25th percentile
2908,51700,Virginia,Newport News (city),2713,3196,277,483,206,0.426501035196687,Top 25th percentile
2909,51710,Virginia,Norfolk (city),3435,3861,320,426,106,0.248826291079812,50th-75th percentile
2910,51139,Virginia,Page,525,618,76,93,17,0.182795698924731,25th-50th percentile
2911,51171,Virginia,Shenandoah,882,1085,135,203,68,0.334975369458128,50th-75th percentile
2912,51740,Virginia,Portsmouth (city),1796,2174,216,378,162,0.428571428571429,Top 25th percentile
2913,51029,Virginia,Buckingham,305,364,41,59,18,0.305084745762712,50th-75th percentile
2914,51037,Virginia,Charlotte,309,354,38,45,7,0.155555555555556,25th-50th percentile
2915,51049,Virginia,Cumberland,173,213,21,40,19,0.475,Top 25th percentile
2916,51065,Virginia,Fluvanna,435,455,25,20,-5,-0.25,Bottom 25th percentile
2917,51147,Virginia,Prince Edward,427,476,40,49,9,0.183673469387755,25th-50th percentile
2918,51153,Virginia,Prince William,3573,4517,562,944,382,0.404661016949153,50th-75th percentile
2919,51155,Virginia,Pulaski,793,944,86,151,65,0.43046357615894,Top 25th percentile
2920,51750,Virginia,Radford (city),235,237,15,2,-13,-6.5,Bottom 25th percentile
2921,51760,Virginia,Richmond (city),3186,3478,334,292,-42,-0.143835616438356,Bottom 25th percentile
2922,51770,Virginia,Roanoke (city),2078,2405,198,327,129,0.394495412844037,50th-75th percentile
2923,51081,Virginia,Greensville,260,273,36,13,-23,-1.76923076923077,Bottom 25th percentile
2924,51093,Virginia,Isle of Wight,638,777,78,139,61,0.438848920863309,Top 25th percentile
2925,51175,Virginia,Southampton,334,411,59,77,18,0.233766233766234,25th-50th percentile
2926,51181,Virginia,Surry,141,161,9,20,11,0.55,Top 25th percentile
2927,51183,Virginia,Sussex,236,281,32,45,13,0.288888888888889,50th-75th percentile
2928,51595,Virginia,Emporia (city),101,178,28,77,49,0.636363636363636,Top 25th percentile
2929,51620,Virginia,Franklin (city),239,297,37,58,21,0.362068965517241,50th-75th percentile
2930,51179,Virginia,Stafford,1457,1591,107,134,27,0.201492537313433,25th-50th percentile
2931,51800,Virginia,Suffolk (city),1418,1740,207,322,115,0.357142857142857,50th-75th percentile
2932,51099,Virginia,King George,353,362,29,9,-20,-2.22222222222222,Bottom 25th percentile
2933,51103,Virginia,Lancaster,390,429,21,39,18,0.461538461538462,Top 25th percentile
2934,51133,Virginia,Northumberland,329,384,36,55,19,0.345454545454545,50th-75th percentile
2935,51159,Virginia,Richmond (county),223,222,15,-1,-16,16.0,Top 25th percentile
2936,51193,Virginia,Westmoreland,427,453,38,26,-12,-0.461538461538462,Bottom 25th percentile
2937,51199,Virginia,York,820,985,80,165,85,0.515151515151515,Top 25th percentile
2938,53001,Washington,Adams,215,232,35,17,-18,-1.05882352941176,Bottom 25th percentile
2939,53025,Washington,Grant,1249,1456,174,207,33,0.159420289855072,25th-50th percentile
2940,53003,Washington,Asotin,454,510,47,56,9,0.160714285714286,25th-50th percentile
2941,53013,Washington,Columbia,98,120,4,22,18,0.818181818181818,Top 25th percentile
2942,53023,Washington,Garfield,48,49,10,1,-9,-9.0,Bottom 25th percentile
2943,53075,Washington,Whitman,475,609,68,134,66,0.492537313432836,Top 25th percentile
2944,53005,Washington,Benton,2639,3142,346,503,157,0.312127236580517,50th-75th percentile
2945,53007,Washington,Chelan,1237,1331,86,94,8,0.0851063829787234,25th-50th percentile
2946,53037,Washington,Kittitas,591,640,54,49,-5,-0.102040816326531,Bottom 25th percentile
2947,53009,Washington,Clallam,1844,2001,65,157,92,0.585987261146497,Top 25th percentile
2948,53031,Washington,Jefferson,692,720,18,28,10,0.357142857142857,50th-75th percentile
2949,53011,Washington,Clark,6442,7266,449,824,375,0.455097087378641,Top 25th percentile
2950,53015,Washington,Cowlitz,2149,2523,219,374,155,0.414438502673797,Top 25th percentile
2951,53039,Washington,Klickitat,372,433,22,61,39,0.639344262295082,Top 25th percentile
2952,53059,Washington,Skamania,164,172,9,8,-1,-0.125,Bottom 25th percentile
2953,53069,Washington,Wahkiakum,87,99,4,12,8,0.666666666666667,Top 25th percentile
2954,53017,Washington,Douglas,555,603,40,48,8,0.166666666666667,25th-50th percentile
2955,53047,Washington,Okanogan,786,873,88,87,-1,-0.0114942528735632,25th-50th percentile
2956,53019,Washington,Ferry,140,179,11,39,28,0.717948717948718,Top 25th percentile
2957,53043,Washington,Lincoln,201,240,28,39,11,0.282051282051282,50th-75th percentile
2958,53051,Washington,Pend Oreille,307,333,23,26,3,0.115384615384615,25th-50th percentile
2959,53065,Washington,Stevens,808,959,96,151,55,0.364238410596026,50th-75th percentile
2960,53021,Washington,Franklin,747,909,157,162,5,0.0308641975308642,25th-50th percentile
2961,53027,Washington,Grays Harbor,1536,1763,121,227,106,0.466960352422908,Top 25th percentile
2962,53049,Washington,Pacific,604,618,25,14,-11,-0.785714285714286,Bottom 25th percentile
2963,53029,Washington,Island,1403,1467,56,64,8,0.125,25th-50th percentile
2964,53033,Washington,King,23590,24525,1604,935,-669,-0.715508021390374,Bottom 25th percentile
2965,53035,Washington,Kitsap,3993,4270,210,277,67,0.24187725631769,50th-75th percentile
2966,53041,Washington,Lewis,1660,1814,142,154,12,0.0779220779220779,25th-50th percentile
2967,53045,Washington,Mason,1253,1355,68,102,34,0.333333333333333,50th-75th percentile
2968,53053,Washington,Pierce,12091,12821,818,730,-88,-0.120547945205479,Bottom 25th percentile
2969,53055,Washington,San Juan,257,260,14,3,-11,-3.66666666666667,Bottom 25th percentile
2970,53057,Washington,Skagit,2195,2404,108,209,101,0.483253588516747,Top 25th percentile
2971,53061,Washington,Snohomish,9753,10405,644,652,8,0.0122699386503067,25th-50th percentile
2972,53063,Washington,Spokane,8166,9270,812,1104,292,0.264492753623188,50th-75th percentile
2973,53067,Washington,Thurston,4181,4527,229,346,117,0.338150289017341,50th-75th percentile
2974,53071,Washington,Walla Walla,1015,1153,91,138,47,0.340579710144928,50th-75th percentile
2975,53073,Washington,Whatcom,3114,3375,145,261,116,0.444444444444444,Top 25th percentile
2976,53077,Washington,Yakima,3512,4205,557,693,136,0.196248196248196,25th-50th percentile
2977,54001,West Virginia,Barbour,335,431,39,96,57,0.59375,Top 25th percentile
2978,54075,West Virginia,Pocahontas,179,206,13,27,14,0.518518518518519,Top 25th percentile
2979,54083,West Virginia,Randolph,628,721,44,93,49,0.526881720430108,Top 25th percentile
2980,54093,West Virginia,Tucker,161,207,26,46,20,0.434782608695652,Top 25th percentile
2981,54003,West Virginia,Berkeley,1839,2317,216,478,262,0.548117154811716,Top 25th percentile
2982,54065,West Virginia,Morgan,395,437,40,42,2,0.0476190476190476,25th-50th percentile
2983,54005,West Virginia,Boone,528,613,44,85,41,0.482352941176471,Top 25th percentile
2984,54043,West Virginia,Lincoln,469,562,47,93,46,0.494623655913979,Top 25th percentile
2985,54045,West Virginia,Logan,917,1041,119,124,5,0.0403225806451613,25th-50th percentile
2986,54007,West Virginia,Braxton,306,310,17,4,-13,-3.25,Bottom 25th percentile
2987,54021,West Virginia,Gilmer,150,160,12,10,-2,-0.2,Bottom 25th percentile
2988,54041,West Virginia,Lewis,401,528,55,127,72,0.566929133858268,Top 25th percentile
2989,54097,West Virginia,Upshur,463,560,62,97,35,0.360824742268041,50th-75th percentile
2990,54009,West Virginia,Brooke,553,713,81,160,79,0.49375,Top 25th percentile
2991,54029,West Virginia,Hancock,727,892,127,165,38,0.23030303030303,25th-50th percentile
2992,54011,West Virginia,Cabell,2043,2353,218,310,92,0.296774193548387,50th-75th percentile
2993,54015,West Virginia,Clay,198,226,18,28,10,0.357142857142857,50th-75th percentile
2994,54019,West Virginia,Fayette,1078,1229,104,151,47,0.311258278145695,50th-75th percentile
2995,54067,West Virginia,Nicholas,559,643,53,84,31,0.369047619047619,50th-75th percentile
2996,54101,West Virginia,Webster,206,219,27,13,-14,-1.07692307692308,Bottom 25th percentile
2997,54025,West Virginia,Greenbrier,862,981,96,119,23,0.19327731092437,25th-50th percentile
2998,54063,West Virginia,Monroe,328,380,30,52,22,0.423076923076923,Top 25th percentile
2999,54089,West Virginia,Summers,348,390,25,42,17,0.404761904761905,50th-75th percentile
3000,54023,West Virginia,Grant,247,283,39,36,-3,-0.0833333333333333,Bottom 25th percentile
3001,54027,West Virginia,Hampshire,458,551,56,93,37,0.397849462365591,50th-75th percentile
3002,54031,West Virginia,Hardy,299,342,34,43,9,0.209302325581395,25th-50th percentile
3003,54057,West Virginia,Mineral,580,690,117,110,-7,-0.0636363636363636,Bottom 25th percentile
3004,54071,West Virginia,Pendleton,163,195,10,32,22,0.6875,Top 25th percentile
3005,54033,West Virginia,Harrison,1481,1622,141,141,0,0.0,25th-50th percentile
3006,54091,West Virginia,Taylor,367,422,34,55,21,0.381818181818182,50th-75th percentile
3007,54013,West Virginia,Calhoun,157,185,8,28,20,0.714285714285714,Top 25th percentile
3008,54035,West Virginia,Jackson,638,699,71,61,-10,-0.163934426229508,Bottom 25th percentile
3009,54053,West Virginia,Mason,616,715,67,99,32,0.323232323232323,50th-75th percentile
3010,54087,West Virginia,Roane,348,369,21,21,0,0.0,25th-50th percentile
3011,54105,West Virginia,Wirt,108,131,17,23,6,0.260869565217391,50th-75th percentile
3012,54037,West Virginia,Jefferson,845,991,88,146,58,0.397260273972603,50th-75th percentile
3013,54039,West Virginia,Kanawha,4125,4889,424,764,340,0.445026178010471,Top 25th percentile
3014,54047,West Virginia,McDowell,511,609,56,98,42,0.428571428571429,Top 25th percentile
3015,54055,West Virginia,Mercer,1489,1804,175,315,140,0.444444444444444,Top 25th percentile
3016,54049,West Virginia,Marion,1234,1343,108,109,1,0.0091743119266055,25th-50th percentile
3017,54051,West Virginia,Marshall,677,831,117,154,37,0.24025974025974,25th-50th percentile
3018,54069,West Virginia,Ohio,993,1189,105,196,91,0.464285714285714,Top 25th percentile
3019,54059,West Virginia,Mingo,586,734,94,148,54,0.364864864864865,50th-75th percentile
3020,54099,West Virginia,Wayne,865,1095,99,230,131,0.569565217391304,Top 25th percentile
3021,54061,West Virginia,Monongalia,1241,1380,112,139,27,0.194244604316547,25th-50th percentile
3022,54077,West Virginia,Preston,640,759,96,119,23,0.19327731092437,25th-50th percentile
3023,54079,West Virginia,Putnam,1035,1181,98,146,48,0.328767123287671,50th-75th percentile
3024,54081,West Virginia,Raleigh,1747,2076,136,329,193,0.586626139817629,Top 25th percentile
3025,54109,West Virginia,Wyoming,515,639,63,124,61,0.491935483870968,Top 25th percentile
3026,54017,West Virginia,Doddridge,139,151,6,12,6,0.5,Top 25th percentile
3027,54073,West Virginia,Pleasants,169,195,24,26,2,0.0769230769230769,25th-50th percentile
3028,54085,West Virginia,Ritchie,203,241,19,38,19,0.5,Top 25th percentile
3029,54095,West Virginia,Tyler,192,202,29,10,-19,-1.9,Bottom 25th percentile
3030,54103,West Virginia,Wetzel,384,464,54,80,26,0.325,50th-75th percentile
3031,54107,West Virginia,Wood,1875,2198,222,323,101,0.312693498452012,50th-75th percentile
3032,55001,Wisconsin,Adams,455,503,36,48,12,0.25,50th-75th percentile
3033,55057,Wisconsin,Juneau,514,543,34,29,-5,-0.172413793103448,Bottom 25th percentile
3034,55081,Wisconsin,Monroe,746,877,56,131,75,0.572519083969466,Top 25th percentile
3035,55123,Wisconsin,Vernon,526,617,43,91,48,0.527472527472528,Top 25th percentile
3036,55003,Wisconsin,Ashland,329,322,13,-7,-20,2.85714285714286,Top 25th percentile
3037,55007,Wisconsin,Bayfield,318,324,22,6,-16,-2.66666666666667,Bottom 25th percentile
3038,55031,Wisconsin,Douglas,737,891,76,154,78,0.506493506493507,Top 25th percentile
3039,55099,Wisconsin,Price,338,341,11,3,-8,-2.66666666666667,Bottom 25th percentile
3040,55005,Wisconsin,Barron,915,1028,87,113,26,0.230088495575221,25th-50th percentile
3041,55113,Wisconsin,Sawyer,381,441,34,60,26,0.433333333333333,Top 25th percentile
3042,55129,Wisconsin,Washburn,372,436,23,64,41,0.640625,Top 25th percentile
3043,55009,Wisconsin,Brown,3604,3973,323,369,46,0.124661246612466,25th-50th percentile
3044,55011,Wisconsin,Buffalo,233,232,16,-1,-17,17.0,Top 25th percentile
3045,55053,Wisconsin,Jackson,359,429,22,70,48,0.685714285714286,Top 25th percentile
3046,55091,Wisconsin,Pepin,123,130,7,7,0,0.0,25th-50th percentile
3047,55121,Wisconsin,Trempealeau,520,532,45,12,-33,-2.75,Bottom 25th percentile
3048,55013,Wisconsin,Burnett,354,360,45,6,-39,-6.5,Bottom 25th percentile
3049,55095,Wisconsin,Polk,813,884,87,71,-16,-0.225352112676056,Bottom 25th percentile
3050,55015,Wisconsin,Calumet,641,682,57,41,-16,-0.390243902439024,Bottom 25th percentile
3051,55139,Wisconsin,Winnebago,2666,2955,256,289,33,0.114186851211073,25th-50th percentile
3052,55017,Wisconsin,Chippewa,1076,1147,98,71,-27,-0.380281690140845,Bottom 25th percentile
3053,55107,Wisconsin,Rusk,337,349,40,12,-28,-2.33333333333333,Bottom 25th percentile
3054,55019,Wisconsin,Clark,592,635,76,43,-33,-0.767441860465116,Bottom 25th percentile
3055,55119,Wisconsin,Taylor,343,363,40,20,-20,-1.0,Bottom 25th percentile
3056,55021,Wisconsin,Columbia,952,1043,69,91,22,0.241758241758242,25th-50th percentile
3057,55023,Wisconsin,Crawford,322,344,15,22,7,0.318181818181818,50th-75th percentile
3058,55043,Wisconsin,Grant,890,1006,78,116,38,0.327586206896552,50th-75th percentile
3059,55103,Wisconsin,Richland,351,387,27,36,9,0.25,50th-75th percentile
3060,55025,Wisconsin,Dane,5759,6233,320,474,154,0.324894514767932,50th-75th percentile
3061,55027,Wisconsin,Dodge,1613,1890,186,277,91,0.328519855595668,50th-75th percentile
3062,55029,Wisconsin,Door,587,644,40,57,17,0.298245614035088,50th-75th percentile
3063,55061,Wisconsin,Kewaunee,335,359,31,24,-7,-0.291666666666667,Bottom 25th percentile
3064,55071,Wisconsin,Manitowoc,1503,1655,94,152,58,0.381578947368421,50th-75th percentile
3065,55033,Wisconsin,Dunn,607,630,41,23,-18,-0.782608695652174,Bottom 25th percentile
3066,55035,Wisconsin,Eau Claire,1528,1688,127,160,33,0.20625,25th-50th percentile
3067,55037,Wisconsin,Florence,116,119,21,3,-18,-6.0,Bottom 25th percentile
3068,55041,Wisconsin,Forest,211,226,22,15,-7,-0.466666666666667,Bottom 25th percentile
3069,55075,Wisconsin,Marinette,952,1027,86,75,-11,-0.146666666666667,Bottom 25th percentile
3070,55083,Wisconsin,Oconto,666,721,73,55,-18,-0.327272727272727,Bottom 25th percentile
3071,55039,Wisconsin,Fond du Lac,1663,1940,173,277,104,0.375451263537906,50th-75th percentile
3072,55045,Wisconsin,Green,607,668,30,61,31,0.508196721311475,Top 25th percentile
3073,55049,Wisconsin,Iowa,368,392,6,24,18,0.75,Top 25th percentile
3074,55065,Wisconsin,Lafayette,276,283,9,7,-2,-0.285714285714286,Bottom 25th percentile
3075,55047,Wisconsin,Green Lake,415,451,34,36,2,0.0555555555555556,25th-50th percentile
3076,55077,Wisconsin,Marquette,349,412,37,63,26,0.412698412698413,Top 25th percentile
3077,55137,Wisconsin,Waushara,509,551,48,42,-6,-0.142857142857143,Bottom 25th percentile
3078,55051,Wisconsin,Iron,152,190,24,38,14,0.368421052631579,50th-75th percentile
3079,55085,Wisconsin,Oneida,822,936,73,114,41,0.359649122807018,50th-75th percentile
3080,55125,Wisconsin,Vilas,537,575,54,38,-16,-0.421052631578947,Bottom 25th percentile
3081,55055,Wisconsin,Jefferson,1221,1442,131,221,90,0.407239819004525,50th-75th percentile
3082,55059,Wisconsin,Kenosha,2495,2819,326,324,-2,-0.0061728395061728,25th-50th percentile
3083,55063,Wisconsin,La Crosse,1776,1937,115,161,46,0.285714285714286,50th-75th percentile
3084,55067,Wisconsin,Langlade,412,501,39,89,50,0.561797752808989,Top 25th percentile
3085,55069,Wisconsin,Lincoln,587,742,102,155,53,0.341935483870968,50th-75th percentile
3086,55078,Wisconsin,Menominee,90,104,19,14,-5,-0.357142857142857,Bottom 25th percentile
3087,55115,Wisconsin,Shawano,832,886,75,54,-21,-0.388888888888889,Bottom 25th percentile
3088,55073,Wisconsin,Marathon,2170,2385,231,215,-16,-0.0744186046511628,Bottom 25th percentile
3089,55079,Wisconsin,Milwaukee,13928,15757,1077,1829,752,0.411153635866594,50th-75th percentile
3090,55087,Wisconsin,Outagamie,2644,2908,264,264,0,0.0,25th-50th percentile
3091,55089,Wisconsin,Ozaukee,1426,1542,130,116,-14,-0.120689655172414,Bottom 25th percentile
3092,55093,Wisconsin,Pierce,507,577,39,70,31,0.442857142857143,Top 25th percentile
3093,55109,Wisconsin,St. Croix,1098,1287,88,189,101,0.534391534391534,Top 25th percentile
3094,55097,Wisconsin,Portage,949,1121,88,172,84,0.488372093023256,Top 25th percentile
3095,55101,Wisconsin,Racine,3307,3812,402,505,103,0.203960396039604,25th-50th percentile
3096,55105,Wisconsin,Rock,2621,2937,224,316,92,0.291139240506329,50th-75th percentile
3097,55111,Wisconsin,Sauk,1125,1230,79,105,26,0.247619047619048,50th-75th percentile
3098,55117,Wisconsin,Sheboygan,1974,2157,179,183,4,0.0218579234972678,25th-50th percentile
3099,55127,Wisconsin,Walworth,1658,1923,178,265,87,0.328301886792453,50th-75th percentile
3100,55131,Wisconsin,Washington,2040,2310,211,270,59,0.218518518518519,25th-50th percentile
3101,55133,Wisconsin,Waukesha,6082,6999,649,917,268,0.292257360959651,50th-75th percentile
3102,55135,Wisconsin,Waupaca,1259,1365,166,106,-60,-0.566037735849057,Bottom 25th percentile
3103,55141,Wisconsin,Wood,1445,1689,127,244,117,0.479508196721312,Top 25th percentile
3104,56003,Wyoming,Big Horn,241,273,42,32,-10,-0.3125,Bottom 25th percentile
3105,56017,Wyoming,Hot Springs,123,156,10,33,23,0.696969696969697,Top 25th percentile
3106,56029,Wyoming,Park,510,655,85,145,60,0.413793103448276,Top 25th percentile
3107,56043,Wyoming,Washakie,150,181,33,31,-2,-0.0645161290322581,Bottom 25th percentile
3108,56013,Wyoming,Fremont,694,924,127,230,103,0.447826086956522,Top 25th percentile
3109,56023,Wyoming,Lincoln,242,286,21,44,23,0.522727272727273,Top 25th percentile
3110,56035,Wyoming,Sublette,100,125,18,25,7,0.28,50th-75th percentile
3111,56039,Wyoming,Teton,162,155,13,-7,-20,2.85714285714286,Top 25th percentile
3112,56021,Wyoming,Laramie,1488,1853,194,365,171,0.468493150684932,Top 25th percentile
3113,56025,Wyoming,Natrona,1232,1549,184,317,133,0.419558359621451,Top 25th percentile
3114,56005,Wyoming,Campbell,425,570,108,145,37,0.255172413793103,50th-75th percentile
3115,56011,Wyoming,Crook,111,161,20,50,30,0.6,Top 25th percentile
3116,56019,Wyoming,Johnson,170,174,6,4,-2,-0.5,Bottom 25th percentile
3117,56033,Wyoming,Sheridan,568,606,51,38,-13,-0.342105263157895,Bottom 25th percentile
3118,56045,Wyoming,Weston,114,154,11,40,29,0.725,Top 25th percentile
3119,56001,Wyoming,Albany,355,420,38,65,27,0.415384615384615,Top 25th percentile
3120,56007,Wyoming,Carbon,209,269,39,60,21,0.35,50th-75th percentile
3121,56009,Wyoming,Converse,207,244,29,37,8,0.216216216216216,25th-50th percentile
3122,56015,Wyoming,Goshen,294,320,40,26,-14,-0.538461538461538,Bottom 25th percentile
3123,56027,Wyoming,Niobrara,46,61,14,15,1,0.0666666666666667,25th-50th percentile
3124,56031,Wyoming,Platte,168,231,22,63,41,0.650793650793651,Top 25th percentile
3125,56037,Wyoming,Sweetwater,497,682,87,185,98,0.52972972972973,Top 25th percentile
3126,56041,Wyoming,Uinta,248,300,22,52,30,0.576923076923077,Top 25th percentile
